filename,width,height,class,xmin,ymin,xmax,ymax,,x,y
1.jpg,100,100,face,32,41,71,78,,39,37
10.jpg,100,100,face,30,45,71,76,,41,31
100.jpg,100,100,face,27,45,69,77,,42,32
1000.jpg,100,100,face,32,43,65,79,,33,36
1001.jpg,100,100,face,34,43,72,76,,38,33
1002.jpg,100,100,face,29,46,67,77,,38,31
1003.jpg,100,100,face,31,44,70,77,,39,33
1004.jpg,100,100,face,31,45,69,77,,38,32
1005.jpg,100,100,face,29,44,72,76,,43,32
1006.jpg,100,100,face,30,46,71,78,,41,32
1007.jpg,100,100,face,33,45,72,78,,39,33
1009.jpg,100,100,face,31,43,67,78,,36,35
101.jpg,100,100,face,33,45,68,74,,35,29
1010.jpg,100,100,face,29,42,74,72,,45,30
1011.jpg,100,100,face,30,43,66,76,,36,33
1012.jpg,100,100,face,33,43,71,78,,38,35
1013.jpg,100,100,face,29,44,73,78,,44,34
1014.jpg,100,100,face,32,44,70,77,,38,33
1015.jpg,100,100,face,28,43,72,79,,44,36
1016.jpg,100,100,face,30,44,73,78,,43,34
1017.jpg,100,100,face,31,43,67,79,,36,36
1018.jpg,100,100,face,30,44,74,79,,44,35
1019.jpg,100,100,face,27,45,73,79,,46,34
102.jpg,100,100,face,29,43,70,79,,41,36
1020.jpg,100,100,face,31,43,71,77,,40,34
1021.jpg,100,100,face,31,45,70,76,,39,31
1022.jpg,100,100,face,30,44,69,78,,39,34
1023.jpg,100,100,face,32,43,73,79,,41,36
1024.jpg,100,100,face,30,43,73,82,,43,39
1025.jpg,100,100,face,28,43,72,77,,44,34
1026.jpg,100,100,face,32,44,69,73,,37,29
1027.jpg,100,100,face,32,45,73,81,,41,36
1028.jpg,100,100,face,32,45,71,80,,39,35
1029.jpg,100,100,face,31,43,68,77,,37,34
103.jpg,100,100,face,33,41,70,77,,37,36
1030.jpg,100,100,face,28,44,73,77,,45,33
1031.jpg,100,100,face,30,43,71,76,,41,33
1032.jpg,100,100,face,31,45,75,78,,44,33
1033.jpg,100,100,face,32,45,70,75,,38,30
1034.jpg,100,100,face,31,44,73,76,,42,32
1035.jpg,100,100,face,34,44,68,80,,34,36
1036.jpg,100,100,face,31,44,72,80,,41,36
1037.jpg,100,100,face,31,42,72,77,,41,35
1038.jpg,100,100,face,33,44,67,75,,34,31
1039.jpg,100,100,face,28,43,71,78,,43,35
104.jpg,100,100,face,29,46,72,76,,43,30
1040.jpg,100,100,face,33,44,70,77,,37,33
1041.jpg,100,100,face,32,45,72,75,,40,30
1042.jpg,100,100,face,31,43,67,76,,36,33
1043.jpg,100,100,face,31,44,70,76,,39,32
1044.jpg,100,100,face,29,43,65,78,,36,35
1045.jpg,100,100,face,27,43,74,75,,47,32
1046.jpg,100,100,face,28,42,73,80,,45,38
1047.jpg,100,100,face,31,43,71,79,,40,36
1048.jpg,100,100,face,30,44,72,75,,42,31
1049.jpg,100,100,face,29,43,71,78,,42,35
105.jpg,100,100,face,30,45,72,77,,42,32
1050.jpg,100,100,face,30,43,75,78,,45,35
1051.jpg,100,100,face,30,43,71,78,,41,35
1052.jpg,100,100,face,29,44,72,78,,43,34
1053.jpg,100,100,face,29,43,71,76,,42,33
1054.jpg,100,100,face,29,42,72,76,,43,34
1055.jpg,100,100,face,32,43,73,77,,41,34
1056.jpg,100,100,face,29,45,71,80,,42,35
1057.jpg,100,100,face,30,43,72,80,,42,37
1058.jpg,100,100,face,29,43,74,76,,45,33
1059.jpg,100,100,face,31,44,73,77,,42,33
106.jpg,100,100,face,32,45,78,79,,46,34
1060.jpg,100,100,face,28,43,72,76,,44,33
1061.jpg,100,100,face,27,43,73,77,,46,34
1062.jpg,100,100,face,29,43,69,74,,40,31
1063.jpg,100,100,face,30,43,70,74,,40,31
1064.jpg,100,100,face,27,43,69,79,,42,36
1065.jpg,100,100,face,27,42,71,76,,44,34
1066.jpg,100,100,face,33,38,72,82,,39,44
1067.jpg,100,100,face,31,43,67,75,,36,32
1068.jpg,100,100,face,36,41,70,84,,34,43
1069.jpg,100,100,face,32,43,64,78,,32,35
107.jpg,100,100,face,31,41,76,82,,45,41
1070.jpg,100,100,face,30,42,75,77,,45,35
1071.jpg,100,100,face,30,43,71,80,,41,37
1072.jpg,100,100,face,31,42,73,82,,42,40
1073.jpg,100,100,face,29,42,72,77,,43,35
1074.jpg,100,100,face,28,41,74,80,,46,39
1075.jpg,100,100,face,31,43,68,77,,37,34
1076.jpg,100,100,face,29,44,72,82,,43,38
1077.jpg,100,100,face,28,44,73,78,,45,34
1078.jpg,100,100,face,29,42,72,83,,43,41
1079.jpg,100,100,face,32,41,75,80,,43,39
108.jpg,100,100,face,31,44,75,78,,44,34
1080.jpg,100,100,face,29,45,74,75,,45,30
1081.jpg,100,100,face,25,42,74,78,,49,36
1082.jpg,100,100,face,29,43,76,76,,47,33
1083.jpg,100,100,face,28,43,71,77,,43,34
1084.jpg,100,100,face,31,41,75,78,,44,37
1085.jpg,100,100,face,29,45,79,81,,50,36
1086.jpg,100,100,face,26,42,82,78,,56,36
1087.jpg,100,100,face,23,42,76,77,,53,35
1088.jpg,100,100,face,30,45,72,78,,42,33
1089.jpg,100,100,face,27,44,71,82,,44,38
109.jpg,100,100,face,30,46,75,75,,45,29
1090.jpg,100,100,face,28,44,72,80,,44,36
1091.jpg,100,100,face,24,43,70,77,,46,34
1092.jpg,100,100,face,24,44,75,77,,51,33
1093.jpg,100,100,face,28,46,75,81,,47,35
1094.jpg,100,100,face,25,43,69,76,,44,33
1095.jpg,100,100,face,25,44,77,77,,52,33
1096.jpg,100,100,face,25,41,67,75,,42,34
1097.jpg,100,100,face,23,44,77,80,,54,36
1098.jpg,100,100,face,34,44,71,78,,37,34
1099.jpg,100,100,face,27,43,74,78,,47,35
11.jpg,100,100,face,28,43,68,81,,40,38
110.jpg,100,100,face,29,45,71,79,,42,34
1100.jpg,100,100,face,28,45,71,78,,43,33
1101.jpg,100,100,face,31,43,68,79,,37,36
1102.jpg,100,100,face,28,45,75,74,,47,29
1103.jpg,100,100,face,29,44,70,78,,41,34
1104.jpg,100,100,face,29,44,76,73,,47,29
1105.jpg,100,100,face,27,44,74,77,,47,33
1106.jpg,100,100,face,27,43,75,79,,48,36
1107.jpg,100,100,face,29,43,67,74,,38,31
1108.jpg,100,100,face,27,45,74,75,,47,30
1109.jpg,100,100,face,29,42,77,76,,48,34
111.jpg,100,100,face,31,46,74,79,,43,33
1110.jpg,100,100,face,26,41,74,79,,48,38
1111.jpg,100,100,face,35,43,74,81,,39,38
1112.jpg,100,100,face,27,44,69,75,,42,31
1113.jpg,100,100,face,26,42,78,81,,52,39
1114.jpg,100,100,face,31,43,71,78,,40,35
1115.jpg,100,100,face,27,43,71,74,,44,31
1116.jpg,100,100,face,30,46,78,79,,48,33
1117.jpg,100,100,face,27,42,72,78,,45,36
1118.jpg,100,100,face,30,46,72,80,,42,34
1119.jpg,100,100,face,27,44,72,75,,45,31
112.jpg,100,100,face,28,41,70,78,,42,37
1120.jpg,100,100,face,27,44,71,77,,44,33
1121.jpg,100,100,face,30,44,70,77,,40,33
1122.jpg,100,100,face,32,44,68,75,,36,31
1123.jpg,100,100,face,28,43,72,78,,44,35
1124.jpg,100,100,face,28,44,76,78,,48,34
1125.jpg,100,100,face,24,45,73,76,,49,31
1126.jpg,100,100,face,28,43,75,79,,47,36
1127.jpg,100,100,face,27,43,76,79,,49,36
1128.jpg,100,100,face,31,46,70,77,,39,31
1129.jpg,100,100,face,28,43,70,79,,42,36
113.jpg,100,100,face,25,44,73,77,,48,33
1130.jpg,100,100,face,32,46,70,75,,38,29
1131.jpg,100,100,face,29,44,73,79,,44,35
1132.jpg,100,100,face,30,40,73,78,,43,38
1133.jpg,100,100,face,35,44,72,77,,37,33
1134.jpg,100,100,face,29,42,73,79,,44,37
1135.jpg,100,100,face,32,44,69,77,,37,33
1136.jpg,100,100,face,29,45,72,80,,43,35
1137.jpg,100,100,face,27,42,72,79,,45,37
1138.jpg,100,100,face,31,44,72,78,,41,34
1139.jpg,100,100,face,33,46,68,77,,35,31
114.jpg,100,100,face,25,43,74,80,,49,37
1140.jpg,100,100,face,29,43,73,77,,44,34
1141.jpg,100,100,face,31,43,69,79,,38,36
1142.jpg,100,100,face,33,44,68,78,,35,34
1143.jpg,100,100,face,29,43,69,79,,40,36
1144.jpg,100,100,face,32,42,73,83,,41,41
1145.jpg,100,100,face,30,43,71,84,,41,41
1146.jpg,100,100,face,31,43,68,78,,37,35
1147.jpg,100,100,face,30,42,72,79,,42,37
1148.jpg,100,100,face,26,42,74,78,,48,36
1149.jpg,100,100,face,28,45,71,76,,43,31
115.jpg,100,100,face,30,44,71,77,,41,33
1150.jpg,100,100,face,35,38,71,82,,36,44
1151.jpg,100,100,face,28,43,70,77,,42,34
1152.jpg,100,100,face,30,43,74,79,,44,36
1153.jpg,100,100,face,32,44,70,76,,38,32
1154.jpg,100,100,face,27,43,74,79,,47,36
1155.jpg,100,100,face,30,43,73,78,,43,35
1156.jpg,100,100,face,31,43,67,78,,36,35
1157.jpg,100,100,face,30,43,68,79,,38,36
1158.jpg,100,100,face,33,43,65,80,,32,37
1159.jpg,100,100,face,29,42,72,78,,43,36
116.jpg,100,100,face,34,44,68,78,,34,34
1160.jpg,100,100,face,31,44,74,76,,43,32
1161.jpg,100,100,face,31,42,68,79,,37,37
1162.jpg,100,100,face,35,44,73,80,,38,36
1163.jpg,100,100,face,30,43,73,74,,43,31
1164.jpg,100,100,face,33,42,70,80,,37,38
1165.jpg,100,100,face,32,42,68,77,,36,35
1166.jpg,100,100,face,34,43,62,75,,28,32
1167.jpg,100,100,face,28,43,72,79,,44,36
1168.jpg,100,100,face,28,43,71,76,,43,33
1169.jpg,100,100,face,31,44,72,77,,41,33
117.jpg,100,100,face,29,42,73,82,,44,40
1170.jpg,100,100,face,34,44,64,82,,30,38
1171.jpg,100,100,face,28,43,75,81,,47,38
1172.jpg,100,100,face,31,43,73,76,,42,33
1173.jpg,100,100,face,31,45,73,77,,42,32
1174.jpg,100,100,face,33,42,77,81,,44,39
1175.jpg,100,100,face,28,44,72,83,,44,39
1176.jpg,100,100,face,31,46,72,82,,41,36
1177.jpg,100,100,face,32,42,72,83,,40,41
1178.jpg,100,100,face,31,43,71,79,,40,36
1179.jpg,100,100,face,30,44,73,82,,43,38
118.jpg,100,100,face,29,44,72,79,,43,35
1180.jpg,100,100,face,30,45,73,76,,43,31
1181.jpg,100,100,face,28,45,72,80,,44,35
1182.jpg,100,100,face,28,45,74,78,,46,33
1183.jpg,100,100,face,30,40,70,79,,40,39
1184.jpg,100,100,face,32,43,72,75,,40,32
1185.jpg,100,100,face,28,44,75,80,,47,36
1186.jpg,100,100,face,32,42,74,77,,42,35
1187.jpg,100,100,face,33,44,73,79,,40,35
1188.jpg,100,100,face,33,41,67,82,,34,41
1189.jpg,100,100,face,31,44,69,76,,38,32
119.jpg,100,100,face,31,44,74,79,,43,35
1190.jpg,100,100,face,30,44,69,79,,39,35
1191.jpg,100,100,face,29,45,74,79,,45,34
1192.jpg,100,100,face,34,47,73,74,,39,27
1193.jpg,100,100,face,31,47,67,73,,36,26
1194.jpg,100,100,face,33,44,69,76,,36,32
1195.jpg,100,100,face,33,43,73,77,,40,34
1196.jpg,100,100,face,33,43,72,78,,39,35
1197.jpg,100,100,face,28,41,72,75,,44,34
1198.jpg,100,100,face,33,44,68,78,,35,34
1199.jpg,100,100,face,29,42,72,76,,43,34
12.jpg,100,100,face,33,47,74,79,,41,32
120.jpg,100,100,face,31,42,72,75,,41,33
1200.jpg,100,100,face,31,43,77,80,,46,37
1201.jpg,100,100,face,27,41,73,81,,46,40
1202.jpg,100,100,face,30,45,76,79,,46,34
1203.jpg,100,100,face,28,44,72,84,,44,40
1204.jpg,100,100,face,29,42,72,80,,43,38
1205.jpg,100,100,face,31,44,72,77,,41,33
1206.jpg,100,100,face,31,41,68,74,,37,33
1207.jpg,100,100,face,29,43,68,77,,39,34
1208.jpg,100,100,face,29,43,71,77,,42,34
1209.jpg,100,100,face,31,43,69,78,,38,35
121.jpg,100,100,face,35,45,72,77,,37,32
1210.jpg,100,100,face,29,45,71,84,,42,39
1211.jpg,100,100,face,29,42,70,80,,41,38
1212.jpg,100,100,face,29,44,72,81,,43,37
1213.jpg,100,100,face,27,43,71,77,,44,34
1214.jpg,100,100,face,32,43,73,74,,41,31
1215.jpg,100,100,face,29,44,71,80,,42,36
1216.jpg,100,100,face,31,43,74,75,,43,32
1217.jpg,100,100,face,32,42,68,73,,36,31
1218.jpg,100,100,face,29,40,67,84,,38,44
1219.jpg,100,100,face,33,43,72,83,,39,40
122.jpg,100,100,face,29,44,74,80,,45,36
1220.jpg,100,100,face,33,43,74,77,,41,34
1221.jpg,100,100,face,32,42,70,85,,38,43
1222.jpg,100,100,face,34,46,68,75,,34,29
1223.jpg,100,100,face,32,41,73,78,,41,37
1224.jpg,100,100,face,27,45,71,78,,44,33
1225.jpg,100,100,face,26,43,76,73,,50,30
1226.jpg,100,100,face,25,45,70,76,,45,31
1227.jpg,100,100,face,29,46,72,76,,43,30
1228.jpg,100,100,face,32,43,69,77,,37,34
1229.jpg,100,100,face,28,44,72,80,,44,36
123.jpg,100,100,face,22,43,71,76,,49,33
1230.jpg,100,100,face,30,44,69,79,,39,35
1231.jpg,100,100,face,36,45,69,79,,33,34
1232.jpg,100,100,face,31,46,75,81,,44,35
1233.jpg,100,100,face,29,43,75,75,,46,32
1234.jpg,100,100,face,26,40,73,73,,47,33
1235.jpg,100,100,face,28,45,69,75,,41,30
1236.jpg,100,100,face,30,45,70,76,,40,31
1237.jpg,100,100,face,27,45,76,75,,49,30
1238.jpg,100,100,face,28,44,70,78,,42,34
1239.jpg,100,100,face,30,45,72,74,,42,29
124.jpg,100,100,face,30,44,72,79,,42,35
1240.jpg,100,100,face,33,47,73,77,,40,30
1241.jpg,100,100,face,29,41,73,81,,44,40
1242.jpg,100,100,face,28,42,76,78,,48,36
1243.jpg,100,100,face,31,43,69,77,,38,34
1244.jpg,100,100,face,30,41,65,74,,35,33
1245.jpg,100,100,face,31,44,71,76,,40,32
1246.jpg,100,100,face,31,44,73,77,,42,33
1247.jpg,100,100,face,28,43,70,77,,42,34
1248.jpg,100,100,face,29,41,70,73,,41,32
1249.jpg,100,100,face,25,42,69,73,,44,31
125.jpg,100,100,face,35,46,72,79,,37,33
1250.jpg,100,100,face,30,44,76,80,,46,36
1251.jpg,100,100,face,30,42,74,78,,44,36
1252.jpg,100,100,face,30,42,71,78,,41,36
1253.jpg,100,100,face,32,43,72,76,,40,33
1254.jpg,100,100,face,28,39,70,73,,42,34
1255.jpg,100,100,face,31,44,71,80,,40,36
1256.jpg,100,100,face,28,41,74,84,,46,43
1257.jpg,100,100,face,28,42,67,78,,39,36
1258.jpg,100,100,face,30,43,67,77,,37,34
1259.jpg,100,100,face,27,43,74,81,,47,38
126.jpg,100,100,face,30,41,71,79,,41,38
1260.jpg,100,100,face,27,43,72,79,,45,36
1261.jpg,100,100,face,31,44,72,84,,41,40
1262.jpg,100,100,face,31,44,66,78,,35,34
1263.jpg,100,100,face,31,45,70,77,,39,32
1264.jpg,100,100,face,29,43,77,80,,48,37
1265.jpg,100,100,face,30,42,76,82,,46,40
1266.jpg,100,100,face,29,43,76,85,,47,42
1267.jpg,100,100,face,25,47,81,79,,56,32
1268.jpg,100,100,face,34,45,73,82,,39,37
1269.jpg,100,100,face,33,45,76,81,,43,36
127.jpg,100,100,face,28,42,68,76,,40,34
1270.jpg,100,100,face,29,45,66,80,,37,35
1271.jpg,100,100,face,29,45,70,74,,41,29
1272.jpg,100,100,face,27,43,67,77,,40,34
1273.jpg,100,100,face,36,44,68,78,,32,34
1274.jpg,100,100,face,33,40,68,79,,35,39
1275.jpg,100,100,face,27,41,63,77,,36,36
1276.jpg,100,100,face,35,45,70,76,,35,31
1277.jpg,100,100,face,34,41,65,87,,31,46
1278.jpg,100,100,face,32,42,74,78,,42,36
1279.jpg,100,100,face,31,43,69,78,,38,35
128.jpg,100,100,face,32,44,72,76,,40,32
1280.jpg,100,100,face,33,45,66,79,,33,34
1281.jpg,100,100,face,28,42,64,78,,36,36
1282.jpg,100,100,face,30,44,67,80,,37,36
1283.jpg,100,100,face,30,40,71,81,,41,41
1284.jpg,100,100,face,30,44,76,80,,46,36
1285.jpg,100,100,face,30,44,72,79,,42,35
1286.jpg,100,100,face,27,40,76,78,,49,38
1287.jpg,100,100,face,29,43,71,86,,42,43
1288.jpg,100,100,face,31,43,67,75,,36,32
1289.jpg,100,100,face,30,42,69,77,,39,35
129.jpg,100,100,face,30,43,77,74,,47,31
1290.jpg,100,100,face,33,44,68,77,,35,33
1291.jpg,100,100,face,27,44,76,80,,49,36
1292.jpg,100,100,face,26,43,79,79,,53,36
1293.jpg,100,100,face,27,43,76,76,,49,33
1294.jpg,100,100,face,25,42,78,78,,53,36
1295.jpg,100,100,face,27,41,79,79,,52,38
1296.jpg,100,100,face,26,43,77,86,,51,43
1297.jpg,100,100,face,23,37,73,81,,50,44
1298.jpg,100,100,face,28,42,79,81,,51,39
1299.jpg,100,100,face,24,43,75,78,,51,35
13.jpg,100,100,face,27,44,73,78,,46,34
130.jpg,100,100,face,28,46,75,74,,47,28
1300.jpg,100,100,face,30,45,71,74,,41,29
1301.jpg,100,100,face,29,41,75,76,,46,35
1302.jpg,100,100,face,30,44,75,75,,45,31
1303.jpg,100,100,face,26,44,76,80,,50,36
1304.jpg,100,100,face,27,44,73,80,,46,36
1305.jpg,100,100,face,29,44,74,78,,45,34
1306.jpg,100,100,face,31,45,76,81,,45,36
1307.jpg,100,100,face,33,44,75,77,,42,33
1308.jpg,100,100,face,31,43,72,84,,41,41
1309.jpg,100,100,face,26,42,73,84,,47,42
131.jpg,100,100,face,30,42,73,84,,43,42
1310.jpg,100,100,face,35,41,77,85,,42,44
1311.jpg,100,100,face,31,43,67,78,,36,35
1312.jpg,100,100,face,33,44,74,80,,41,36
1313.jpg,100,100,face,31,43,78,81,,47,38
1314.jpg,100,100,face,29,43,76,84,,47,41
1315.jpg,100,100,face,26,38,75,78,,49,40
1316.jpg,100,100,face,29,44,70,83,,41,39
1317.jpg,100,100,face,32,45,70,78,,38,33
1318.jpg,100,100,face,33,41,68,78,,35,37
1319.jpg,100,100,face,30,45,76,77,,46,32
132.jpg,100,100,face,28,45,72,82,,44,37
1320.jpg,100,100,face,32,42,74,82,,42,40
1321.jpg,100,100,face,31,44,73,80,,42,36
1322.jpg,100,100,face,27,45,80,80,,53,35
1323.jpg,100,100,face,30,43,69,81,,39,38
1324.jpg,100,100,face,30,43,74,80,,44,37
1325.jpg,100,100,face,30,44,73,77,,43,33
1326.jpg,100,100,face,29,42,70,83,,41,41
1327.jpg,100,100,face,29,46,69,82,,40,36
1328.jpg,100,100,face,29,42,70,80,,41,38
1329.jpg,100,100,face,34,44,71,85,,37,41
133.jpg,100,100,face,31,44,68,83,,37,39
1330.jpg,100,100,face,28,40,74,82,,46,42
1331.jpg,100,100,face,29,42,75,79,,46,37
1332.jpg,100,100,face,30,43,71,80,,41,37
1333.jpg,100,100,face,26,42,78,80,,52,38
1334.jpg,100,100,face,29,43,70,77,,41,34
1335.jpg,100,100,face,29,43,74,79,,45,36
1336.jpg,100,100,face,33,44,68,75,,35,31
1337.jpg,100,100,face,28,43,74,79,,46,36
1338.jpg,100,100,face,27,44,70,80,,43,36
1339.jpg,100,100,face,34,46,74,86,,40,40
134.jpg,100,100,face,35,43,75,81,,40,38
1340.jpg,100,100,face,33,43,73,80,,40,37
1341.jpg,100,100,face,32,42,75,81,,43,39
1342.jpg,100,100,face,30,44,72,78,,42,34
1343.jpg,100,100,face,28,42,70,80,,42,38
1344.jpg,100,100,face,29,44,71,76,,42,32
1345.jpg,100,100,face,33,42,69,76,,36,34
1346.jpg,100,100,face,29,46,69,80,,40,34
1347.jpg,100,100,face,32,41,70,77,,38,36
1348.jpg,100,100,face,27,42,74,76,,47,34
1349.jpg,100,100,face,28,41,68,76,,40,35
135.jpg,100,100,face,32,43,72,75,,40,32
1350.jpg,100,100,face,33,43,69,81,,36,38
1351.jpg,100,100,face,31,45,70,75,,39,30
1352.jpg,100,100,face,32,41,64,83,,32,42
1353.jpg,100,100,face,30,41,70,76,,40,35
1354.jpg,100,100,face,30,44,69,78,,39,34
1355.jpg,100,100,face,33,47,69,78,,36,31
1356.jpg,100,100,face,29,41,72,80,,43,39
1357.jpg,100,100,face,34,44,71,80,,37,36
1358.jpg,100,100,face,31,43,73,80,,42,37
1359.jpg,100,100,face,33,45,68,75,,35,30
136.jpg,100,100,face,34,47,70,78,,36,31
1360.jpg,100,100,face,31,43,68,79,,37,36
1361.jpg,100,100,face,36,43,67,80,,31,37
1362.jpg,100,100,face,32,43,72,78,,40,35
1363.jpg,100,100,face,27,46,77,79,,50,33
1364.jpg,100,100,face,33,43,74,80,,41,37
1365.jpg,100,100,face,33,44,65,78,,32,34
1366.jpg,100,100,face,31,43,71,77,,40,34
1367.jpg,100,100,face,29,43,70,75,,41,32
1368.jpg,100,100,face,26,44,68,76,,42,32
1369.jpg,100,100,face,31,42,71,77,,40,35
137.jpg,100,100,face,33,42,68,76,,35,34
1370.jpg,100,100,face,32,44,69,78,,37,34
1371.jpg,100,100,face,33,45,72,78,,39,33
1372.jpg,100,100,face,24,43,80,78,,56,35
1373.jpg,100,100,face,28,44,70,74,,42,30
1374.jpg,100,100,face,33,44,68,77,,35,33
1375.jpg,100,100,face,31,42,68,80,,37,38
1376.jpg,100,100,face,30,43,71,78,,41,35
1377.jpg,100,100,face,29,44,70,75,,41,31
1378.jpg,100,100,face,30,41,69,79,,39,38
1379.jpg,100,100,face,35,45,68,76,,33,31
138.jpg,100,100,face,32,42,71,79,,39,37
1380.jpg,100,100,face,33,43,70,83,,37,40
1381.jpg,100,100,face,32,43,66,75,,34,32
1382.jpg,100,100,face,31,44,67,74,,36,30
1383.jpg,100,100,face,33,44,70,77,,37,33
1384.jpg,100,100,face,32,42,70,79,,38,37
1385.jpg,100,100,face,27,41,74,81,,47,40
1386.jpg,100,100,face,31,43,69,79,,38,36
1387.jpg,100,100,face,32,42,74,82,,42,40
1388.jpg,100,100,face,31,40,74,81,,43,41
1389.jpg,100,100,face,29,42,70,74,,41,32
139.jpg,100,100,face,33,43,69,78,,36,35
1390.jpg,100,100,face,31,43,72,78,,41,35
1391.jpg,100,100,face,31,42,67,78,,36,36
1392.jpg,100,100,face,32,42,69,78,,37,36
1393.jpg,100,100,face,30,41,75,78,,45,37
1394.jpg,100,100,face,28,42,74,78,,46,36
1395.jpg,100,100,face,31,43,69,76,,38,33
1396.jpg,100,100,face,29,43,72,82,,43,39
1397.jpg,100,100,face,32,46,72,76,,40,30
1398.jpg,100,100,face,30,43,73,79,,43,36
1399.jpg,100,100,face,30,42,72,77,,42,35
14.jpg,100,100,face,32,42,71,82,,39,40
140.jpg,100,100,face,33,41,70,79,,37,38
1400.jpg,100,100,face,37,41,71,79,,34,38
1401.jpg,100,100,face,33,42,69,78,,36,36
1402.jpg,100,100,face,31,42,71,77,,40,35
1403.jpg,100,100,face,27,41,70,75,,43,34
1404.jpg,100,100,face,31,41,70,73,,39,32
1405.jpg,100,100,face,27,44,72,76,,45,32
1406.jpg,100,100,face,27,43,71,78,,44,35
1407.jpg,100,100,face,29,42,74,78,,45,36
1408.jpg,100,100,face,31,42,70,74,,39,32
1409.jpg,100,100,face,29,43,70,79,,41,36
141.jpg,100,100,face,28,44,72,78,,44,34
1410.jpg,100,100,face,28,43,75,79,,47,36
1411.jpg,100,100,face,33,46,70,77,,37,31
1412.jpg,100,100,face,28,44,76,77,,48,33
1413.jpg,100,100,face,36,42,71,79,,35,37
1414.jpg,100,100,face,34,44,72,77,,38,33
1415.jpg,100,100,face,29,42,71,78,,42,36
1416.jpg,100,100,face,31,43,70,76,,39,33
1417.jpg,100,100,face,32,45,74,76,,42,31
1418.jpg,100,100,face,26,42,74,84,,48,42
1419.jpg,100,100,face,31,45,74,82,,43,37
142.jpg,100,100,face,34,43,65,84,,31,41
1420.jpg,100,100,face,29,43,72,79,,43,36
1421.jpg,100,100,face,33,46,71,82,,38,36
1422.jpg,100,100,face,31,42,72,82,,41,40
1423.jpg,100,100,face,31,41,69,83,,38,42
1424.jpg,100,100,face,32,41,72,85,,40,44
1425.jpg,100,100,face,30,42,76,83,,46,41
1426.jpg,100,100,face,32,42,72,78,,40,36
1427.jpg,100,100,face,30,41,67,79,,37,38
1428.jpg,100,100,face,33,40,72,81,,39,41
1429.jpg,100,100,face,24,40,72,84,,48,44
143.jpg,100,100,face,31,45,72,78,,41,33
1430.jpg,100,100,face,30,42,82,79,,52,37
1431.jpg,100,100,face,34,41,67,78,,33,37
1432.jpg,100,100,face,31,41,71,79,,40,38
1433.jpg,100,100,face,31,41,68,78,,37,37
1434.jpg,100,100,face,32,43,75,80,,43,37
1435.jpg,100,100,face,34,40,71,78,,37,38
1436.jpg,100,100,face,34,43,67,82,,33,39
1437.jpg,100,100,face,32,45,71,80,,39,35
1438.jpg,100,100,face,33,42,67,77,,34,35
1439.jpg,100,100,face,31,43,74,78,,43,35
144.jpg,100,100,face,27,42,75,79,,48,37
1440.jpg,100,100,face,30,43,71,77,,41,34
1441.jpg,100,100,face,27,42,74,77,,47,35
1442.jpg,100,100,face,30,42,66,75,,36,33
1443.jpg,100,100,face,32,43,66,76,,34,33
1444.jpg,100,100,face,28,42,70,81,,42,39
1445.jpg,100,100,face,29,41,73,78,,44,37
1446.jpg,100,100,face,29,42,70,74,,41,32
1447.jpg,100,100,face,29,41,71,76,,42,35
1448.jpg,100,100,face,33,43,64,82,,31,39
1449.jpg,100,100,face,31,41,70,74,,39,33
145.jpg,100,100,face,31,43,70,79,,39,36
1450.jpg,100,100,face,29,42,73,80,,44,38
1451.jpg,100,100,face,28,43,75,77,,47,34
1452.jpg,100,100,face,30,45,72,79,,42,34
1453.jpg,100,100,face,25,41,73,81,,48,40
1454.jpg,100,100,face,32,44,72,79,,40,35
1455.jpg,100,100,face,27,41,74,79,,47,38
1456.jpg,100,100,face,29,41,69,80,,40,39
1457.jpg,100,100,face,30,42,71,84,,41,42
1458.jpg,100,100,face,31,38,69,83,,38,45
1459.jpg,100,100,face,31,41,75,79,,44,38
146.jpg,100,100,face,26,39,76,79,,50,40
1460.jpg,100,100,face,30,41,72,77,,42,36
1461.jpg,100,100,face,29,40,73,80,,44,40
1462.jpg,100,100,face,26,39,76,87,,50,48
1463.jpg,100,100,face,29,40,70,78,,41,38
1464.jpg,100,100,face,29,44,69,82,,40,38
1465.jpg,100,100,face,27,43,77,76,,50,33
1466.jpg,100,100,face,29,41,75,81,,46,40
1467.jpg,100,100,face,29,44,75,79,,46,35
1468.jpg,100,100,face,28,42,71,82,,43,40
1469.jpg,100,100,face,28,43,70,81,,42,38
147.jpg,100,100,face,30,43,67,79,,37,36
1470.jpg,100,100,face,30,43,71,81,,41,38
1471.jpg,100,100,face,32,44,67,75,,35,31
1472.jpg,100,100,face,33,42,72,78,,39,36
1473.jpg,100,100,face,28,44,71,84,,43,40
1474.jpg,100,100,face,27,42,71,81,,44,39
1475.jpg,100,100,face,30,45,66,81,,36,36
1476.jpg,100,100,face,33,39,69,86,,36,47
1477.jpg,100,100,face,31,44,67,81,,36,37
1478.jpg,100,100,face,31,44,74,79,,43,35
1479.jpg,100,100,face,30,41,72,79,,42,38
148.jpg,100,100,face,27,42,75,77,,48,35
1480.jpg,100,100,face,31,45,72,78,,41,33
1481.jpg,100,100,face,28,44,68,81,,40,37
1482.jpg,100,100,face,28,42,75,86,,47,44
1483.jpg,100,100,face,28,44,72,79,,44,35
1484.jpg,100,100,face,32,41,65,80,,33,39
1485.jpg,100,100,face,29,43,69,77,,40,34
1486.jpg,100,100,face,26,44,75,80,,49,36
1487.jpg,100,100,face,31,44,75,78,,44,34
1488.jpg,100,100,face,28,43,71,79,,43,36
1489.jpg,100,100,face,28,45,74,80,,46,35
149.jpg,100,100,face,28,44,70,77,,42,33
1490.jpg,100,100,face,31,45,73,79,,42,34
1491.jpg,100,100,face,31,43,70,82,,39,39
1492.jpg,100,100,face,33,44,69,83,,36,39
1493.jpg,100,100,face,31,41,74,84,,43,43
1494.jpg,100,100,face,29,44,71,79,,42,35
1495.jpg,100,100,face,30,43,70,80,,40,37
1496.jpg,100,100,face,30,41,68,79,,38,38
1497.jpg,100,100,face,32,43,70,81,,38,38
1498.jpg,100,100,face,34,42,71,78,,37,36
1499.jpg,100,100,face,29,42,69,83,,40,41
15.jpg,100,100,face,30,43,75,79,,45,36
150.jpg,100,100,face,30,42,73,87,,43,45
1500.jpg,100,100,face,30,41,69,80,,39,39
1501.jpg,100,100,face,29,42,73,78,,44,36
1502.jpg,100,100,face,25,43,77,78,,52,35
1503.jpg,100,100,face,29,44,71,80,,42,36
1504.jpg,100,100,face,26,43,75,80,,49,37
1505.jpg,100,100,face,30,42,73,82,,43,40
1506.jpg,100,100,face,31,42,69,79,,38,37
1507.jpg,100,100,face,28,43,71,77,,43,34
1508.jpg,100,100,face,26,45,72,79,,46,34
1509.jpg,100,100,face,29,42,68,76,,39,34
151.jpg,100,100,face,31,45,69,75,,38,30
1510.jpg,100,100,face,28,44,79,83,,51,39
1511.jpg,100,100,face,30,44,72,80,,42,36
1512.jpg,100,100,face,29,42,63,80,,34,38
1513.jpg,100,100,face,30,45,69,79,,39,34
1514.jpg,100,100,face,32,42,66,79,,34,37
1515.jpg,100,100,face,32,44,71,78,,39,34
1516.jpg,100,100,face,26,40,74,82,,48,42
1517.jpg,100,100,face,29,44,74,79,,45,35
1518.jpg,100,100,face,29,43,76,82,,47,39
1519.jpg,100,100,face,33,45,70,82,,37,37
152.jpg,100,100,face,27,44,76,83,,49,39
1520.jpg,100,100,face,30,40,73,82,,43,42
1521.jpg,100,100,face,32,46,71,82,,39,36
1522.jpg,100,100,face,31,43,71,79,,40,36
1523.jpg,100,100,face,29,40,70,80,,41,40
1524.jpg,100,100,face,30,43,74,82,,44,39
1525.jpg,100,100,face,32,44,68,81,,36,37
1526.jpg,100,100,face,33,41,74,80,,41,39
1527.jpg,100,100,face,32,42,74,76,,42,34
1528.jpg,100,100,face,28,45,71,81,,43,36
1529.jpg,100,100,face,34,43,69,83,,35,40
153.jpg,100,100,face,32,46,70,78,,38,32
1530.jpg,100,100,face,29,45,78,79,,49,34
1531.jpg,100,100,face,28,44,73,76,,45,32
1532.jpg,100,100,face,29,46,74,79,,45,33
1533.jpg,100,100,face,24,43,77,78,,53,35
1534.jpg,100,100,face,30,43,75,81,,45,38
1535.jpg,100,100,face,28,44,72,83,,44,39
1536.jpg,100,100,face,32,45,81,84,,49,39
1537.jpg,100,100,face,32,42,72,80,,40,38
1538.jpg,100,100,face,27,43,67,81,,40,38
1539.jpg,100,100,face,27,44,75,85,,48,41
154.jpg,100,100,face,29,44,73,83,,44,39
1540.jpg,100,100,face,31,45,76,80,,45,35
1541.jpg,100,100,face,30,42,72,78,,42,36
1542.jpg,100,100,face,28,44,70,78,,42,34
1543.jpg,100,100,face,33,43,62,74,,29,31
1544.jpg,100,100,face,29,44,75,82,,46,38
1545.jpg,100,100,face,24,42,67,82,,43,40
1546.jpg,100,100,face,30,44,71,81,,41,37
1547.jpg,100,100,face,32,44,66,80,,34,36
1548.jpg,100,100,face,36,45,65,77,,29,32
1549.jpg,100,100,face,24,42,77,83,,53,41
155.jpg,100,100,face,30,44,74,81,,44,37
1550.jpg,100,100,face,28,45,69,79,,41,34
1551.jpg,100,100,face,32,42,74,78,,42,36
1552.jpg,100,100,face,33,43,72,74,,39,31
1553.jpg,100,100,face,34,44,74,83,,40,39
1554.jpg,100,100,face,31,43,70,80,,39,37
1555.jpg,100,100,face,32,44,76,79,,44,35
1556.jpg,100,100,face,30,43,70,80,,40,37
1557.jpg,100,100,face,32,42,69,76,,37,34
1558.jpg,100,100,face,30,43,71,77,,41,34
1559.jpg,100,100,face,27,43,73,79,,46,36
156.jpg,100,100,face,29,45,69,75,,40,30
1560.jpg,100,100,face,31,45,73,79,,42,34
1561.jpg,100,100,face,33,43,70,77,,37,34
1562.jpg,100,100,face,34,44,67,78,,33,34
1563.jpg,100,100,face,30,42,68,79,,38,37
1564.jpg,100,100,face,29,44,72,77,,43,33
1565.jpg,100,100,face,30,44,70,79,,40,35
1566.jpg,100,100,face,33,46,72,81,,39,35
1567.jpg,100,100,face,30,45,71,83,,41,38
1568.jpg,100,100,face,32,45,67,76,,35,31
1569.jpg,100,100,face,30,44,77,79,,47,35
157.jpg,100,100,face,33,45,70,77,,37,32
1570.jpg,100,100,face,32,44,71,81,,39,37
1571.jpg,100,100,face,29,45,72,77,,43,32
1572.jpg,100,100,face,29,44,71,76,,42,32
1573.jpg,100,100,face,30,45,72,75,,42,30
1574.jpg,100,100,face,25,43,70,79,,45,36
1575.jpg,100,100,face,27,44,73,80,,46,36
1576.jpg,100,100,face,31,44,71,77,,40,33
1577.jpg,100,100,face,31,42,77,81,,46,39
1578.jpg,100,100,face,29,43,74,79,,45,36
1579.jpg,100,100,face,29,43,71,76,,42,33
158.jpg,100,100,face,31,42,78,82,,47,40
1580.jpg,100,100,face,31,44,67,79,,36,35
1581.jpg,100,100,face,30,43,72,81,,42,38
1582.jpg,100,100,face,35,46,73,78,,38,32
1583.jpg,100,100,face,35,42,78,78,,43,36
1584.jpg,100,100,face,34,45,71,77,,37,32
1585.jpg,100,100,face,33,44,73,81,,40,37
1586.jpg,100,100,face,31,46,72,83,,41,37
1587.jpg,100,100,face,33,44,67,79,,34,35
1588.jpg,100,100,face,28,42,69,81,,41,39
1589.jpg,100,100,face,30,45,72,79,,42,34
159.jpg,100,100,face,26,42,71,83,,45,41
1590.jpg,100,100,face,28,41,66,79,,38,38
1591.jpg,100,100,face,31,43,65,75,,34,32
1592.jpg,100,100,face,31,42,71,79,,40,37
1593.jpg,100,100,face,33,41,69,81,,36,40
1594.jpg,100,100,face,31,42,68,75,,37,33
1595.jpg,100,100,face,30,43,71,79,,41,36
1596.jpg,100,100,face,31,40,66,81,,35,41
1597.jpg,100,100,face,30,42,73,80,,43,38
1598.jpg,100,100,face,30,40,67,74,,37,34
1599.jpg,100,100,face,30,44,63,79,,33,35
16.jpg,100,100,face,31,42,69,75,,38,33
160.jpg,100,100,face,33,44,71,76,,38,32
1600.jpg,100,100,face,31,42,73,76,,42,34
1601.jpg,100,100,face,29,44,75,77,,46,33
1602.jpg,100,100,face,28,40,75,76,,47,36
1603.jpg,100,100,face,30,44,73,76,,43,32
1604.jpg,100,100,face,29,44,70,74,,41,30
1605.jpg,100,100,face,30,42,74,77,,44,35
1606.jpg,100,100,face,31,40,74,78,,43,38
1607.jpg,100,100,face,35,41,68,75,,33,34
1608.jpg,100,100,face,30,39,74,81,,44,42
1609.jpg,100,100,face,31,44,72,83,,41,39
161.jpg,100,100,face,32,43,69,77,,37,34
1610.jpg,100,100,face,32,46,75,80,,43,34
1611.jpg,100,100,face,30,44,71,77,,41,33
1612.jpg,100,100,face,29,43,77,84,,48,41
1613.jpg,100,100,face,29,41,68,76,,39,35
1614.jpg,100,100,face,30,44,71,73,,41,29
1615.jpg,100,100,face,27,41,74,72,,47,31
1616.jpg,100,100,face,29,44,76,76,,47,32
1617.jpg,100,100,face,32,44,83,80,,51,36
1618.jpg,100,100,face,26,45,72,84,,46,39
1619.jpg,100,100,face,30,43,75,84,,45,41
162.jpg,100,100,face,27,41,74,84,,47,43
1620.jpg,100,100,face,28,45,76,77,,48,32
1621.jpg,100,100,face,31,44,73,77,,42,33
1622.jpg,100,100,face,31,44,70,77,,39,33
1623.jpg,100,100,face,30,42,78,79,,48,37
1624.jpg,100,100,face,26,44,64,82,,38,38
1625.jpg,100,100,face,29,42,70,80,,41,38
1626.jpg,100,100,face,31,44,71,80,,40,36
1627.jpg,100,100,face,30,44,67,78,,37,34
1628.jpg,100,100,face,33,45,73,83,,40,38
1629.jpg,100,100,face,32,44,71,81,,39,37
163.jpg,100,100,face,32,43,71,75,,39,32
1630.jpg,100,100,face,33,45,75,74,,42,29
1631.jpg,100,100,face,21,41,81,76,,60,35
1632.jpg,100,100,face,35,44,70,77,,35,33
1633.jpg,100,100,face,32,44,74,82,,42,38
1634.jpg,100,100,face,30,42,69,77,,39,35
1635.jpg,100,100,face,27,40,76,82,,49,42
1636.jpg,100,100,face,27,41,73,79,,46,38
1637.jpg,100,100,face,29,40,75,81,,46,41
1638.jpg,100,100,face,28,42,67,82,,39,40
1639.jpg,100,100,face,32,42,70,76,,38,34
164.jpg,100,100,face,30,41,72,81,,42,40
1640.jpg,100,100,face,26,39,77,80,,51,41
1641.jpg,100,100,face,29,42,75,79,,46,37
1642.jpg,100,100,face,27,41,74,80,,47,39
1643.jpg,100,100,face,29,40,77,80,,48,40
1644.jpg,100,100,face,31,43,74,73,,43,30
1645.jpg,100,100,face,31,44,71,73,,40,29
1646.jpg,100,100,face,36,42,68,79,,32,37
1647.jpg,100,100,face,26,40,77,79,,51,39
1648.jpg,100,100,face,35,43,68,77,,33,34
1649.jpg,100,100,face,32,45,70,86,,38,41
165.jpg,100,100,face,26,42,74,79,,48,37
1650.jpg,100,100,face,32,41,73,77,,41,36
1651.jpg,100,100,face,31,44,71,75,,40,31
1652.jpg,100,100,face,32,45,71,80,,39,35
1653.jpg,100,100,face,29,44,77,79,,48,35
1654.jpg,100,100,face,30,43,64,80,,34,37
1655.jpg,100,100,face,29,43,69,78,,40,35
1656.jpg,100,100,face,33,45,71,79,,38,34
1657.jpg,100,100,face,28,40,70,78,,42,38
1658.jpg,100,100,face,28,44,71,78,,43,34
1659.jpg,100,100,face,31,43,71,78,,40,35
166.jpg,100,100,face,32,43,62,73,,30,30
1660.jpg,100,100,face,29,43,70,76,,41,33
1661.jpg,100,100,face,32,44,70,80,,38,36
1662.jpg,100,100,face,28,44,71,75,,43,31
1663.jpg,100,100,face,29,44,66,74,,37,30
1664.jpg,100,100,face,26,41,72,79,,46,38
1665.jpg,100,100,face,35,47,69,77,,34,30
1666.jpg,100,100,face,30,41,75,80,,45,39
1667.jpg,100,100,face,32,45,71,80,,39,35
1668.jpg,100,100,face,35,41,74,83,,39,42
1669.jpg,100,100,face,33,41,70,76,,37,35
167.jpg,100,100,face,33,42,68,76,,35,34
1670.jpg,100,100,face,32,43,69,79,,37,36
1671.jpg,100,100,face,29,41,71,76,,42,35
1672.jpg,100,100,face,31,44,70,81,,39,37
1673.jpg,100,100,face,32,43,72,78,,40,35
1674.jpg,100,100,face,36,44,68,82,,32,38
1675.jpg,100,100,face,28,46,71,83,,43,37
1676.jpg,100,100,face,32,43,64,78,,32,35
1677.jpg,100,100,face,29,43,74,83,,45,40
1678.jpg,100,100,face,31,43,69,79,,38,36
1679.jpg,100,100,face,31,45,66,81,,35,36
168.jpg,100,100,face,30,42,70,79,,40,37
1680.jpg,100,100,face,30,42,70,77,,40,35
1681.jpg,100,100,face,27,43,69,78,,42,35
1682.jpg,100,100,face,31,43,71,78,,40,35
1683.jpg,100,100,face,30,41,74,79,,44,38
1684.jpg,100,100,face,33,43,75,79,,42,36
1685.jpg,100,100,face,24,43,74,81,,50,38
1686.jpg,100,100,face,28,42,75,78,,47,36
1687.jpg,100,100,face,30,42,75,78,,45,36
1688.jpg,100,100,face,32,42,75,82,,43,40
1689.jpg,100,100,face,29,42,65,76,,36,34
169.jpg,100,100,face,33,41,76,85,,43,44
1690.jpg,100,100,face,36,43,74,79,,38,36
1691.jpg,100,100,face,32,40,75,82,,43,42
1692.jpg,100,100,face,31,43,69,77,,38,34
1693.jpg,100,100,face,28,43,70,82,,42,39
1694.jpg,100,100,face,27,44,74,81,,47,37
1695.jpg,100,100,face,28,43,74,79,,46,36
1696.jpg,100,100,face,34,43,77,83,,43,40
1697.jpg,100,100,face,30,43,71,78,,41,35
1698.jpg,100,100,face,29,44,76,80,,47,36
1699.jpg,100,100,face,29,46,77,80,,48,34
17.jpg,100,100,face,29,45,72,78,,43,33
170.jpg,100,100,face,27,43,73,77,,46,34
1700.jpg,100,100,face,31,44,70,78,,39,34
1701.jpg,100,100,face,28,44,75,80,,47,36
1702.jpg,100,100,face,35,43,75,80,,40,37
1703.jpg,100,100,face,32,41,70,76,,38,35
1704.jpg,100,100,face,32,44,73,80,,41,36
1705.jpg,100,100,face,29,43,68,75,,39,32
1706.jpg,100,100,face,30,44,69,76,,39,32
1707.jpg,100,100,face,30,42,71,82,,41,40
1708.jpg,100,100,face,30,40,70,83,,40,43
1709.jpg,100,100,face,34,41,70,74,,36,33
171.jpg,100,100,face,33,41,72,79,,39,38
1710.jpg,100,100,face,33,42,71,79,,38,37
1711.jpg,100,100,face,25,41,75,79,,50,38
1712.jpg,100,100,face,27,43,77,84,,50,41
1713.jpg,100,100,face,33,44,69,78,,36,34
1714.jpg,100,100,face,34,41,72,87,,38,46
1715.jpg,100,100,face,29,41,75,78,,46,37
1716.jpg,100,100,face,37,41,74,79,,37,38
1717.jpg,100,100,face,31,42,74,81,,43,39
1718.jpg,100,100,face,31,43,75,78,,44,35
1719.jpg,100,100,face,28,41,74,80,,46,39
172.jpg,100,100,face,31,45,76,79,,45,34
1720.jpg,100,100,face,30,42,68,79,,38,37
1721.jpg,100,100,face,27,42,70,80,,43,38
1722.jpg,100,100,face,29,45,75,78,,46,33
1723.jpg,100,100,face,31,43,71,75,,40,32
1724.jpg,100,100,face,33,45,66,80,,33,35
1725.jpg,100,100,face,29,43,72,79,,43,36
1726.jpg,100,100,face,32,43,72,77,,40,34
1727.jpg,100,100,face,24,45,77,77,,53,32
1728.jpg,100,100,face,33,42,71,76,,38,34
1729.jpg,100,100,face,32,42,71,78,,39,36
173.jpg,100,100,face,33,44,75,77,,42,33
1730.jpg,100,100,face,31,45,72,77,,41,32
1731.jpg,100,100,face,28,45,77,78,,49,33
1732.jpg,100,100,face,31,45,74,80,,43,35
1733.jpg,100,100,face,30,42,77,83,,47,41
1734.jpg,100,100,face,30,42,73,81,,43,39
1735.jpg,100,100,face,32,43,70,81,,38,38
1736.jpg,100,100,face,29,45,68,75,,39,30
1737.jpg,100,100,face,27,42,67,79,,40,37
1738.jpg,100,100,face,34,44,72,81,,38,37
1739.jpg,100,100,face,30,43,73,81,,43,38
174.jpg,100,100,face,32,44,78,83,,46,39
1740.jpg,100,100,face,31,45,72,80,,41,35
1741.jpg,100,100,face,31,41,72,80,,41,39
1742.jpg,100,100,face,36,45,72,79,,36,34
1743.jpg,100,100,face,32,44,74,78,,42,34
1744.jpg,100,100,face,29,45,80,80,,51,35
1745.jpg,100,100,face,30,44,73,77,,43,33
1746.jpg,100,100,face,28,44,77,80,,49,36
1747.jpg,100,100,face,31,45,72,72,,41,27
1748.jpg,100,100,face,28,42,75,81,,47,39
1749.jpg,100,100,face,32,44,69,84,,37,40
175.jpg,100,100,face,29,38,67,81,,38,43
1750.jpg,100,100,face,27,39,80,82,,53,43
1751.jpg,100,100,face,33,42,76,79,,43,37
1752.jpg,100,100,face,28,43,76,83,,48,40
1753.jpg,100,100,face,34,44,72,79,,38,35
1754.jpg,100,100,face,29,43,69,84,,40,41
1755.jpg,100,100,face,32,42,67,80,,35,38
1756.jpg,100,100,face,29,44,79,76,,50,32
1757.jpg,100,100,face,28,42,73,75,,45,33
1758.jpg,100,100,face,24,42,77,82,,53,40
1759.jpg,100,100,face,31,44,76,82,,45,38
176.jpg,100,100,face,31,41,74,82,,43,41
1760.jpg,100,100,face,32,40,69,77,,37,37
1761.jpg,100,100,face,32,42,70,81,,38,39
1762.jpg,100,100,face,34,42,69,78,,35,36
1763.jpg,100,100,face,32,43,72,79,,40,36
1764.jpg,100,100,face,29,42,71,76,,42,34
1765.jpg,100,100,face,31,43,73,75,,42,32
1766.jpg,100,100,face,29,44,73,78,,44,34
1767.jpg,100,100,face,27,44,72,78,,45,34
1768.jpg,100,100,face,27,43,71,79,,44,36
1769.jpg,100,100,face,26,43,74,83,,48,40
177.jpg,100,100,face,30,44,76,81,,46,37
1770.jpg,100,100,face,29,43,74,79,,45,36
1771.jpg,100,100,face,28,43,71,79,,43,36
1772.jpg,100,100,face,32,43,70,80,,38,37
1773.jpg,100,100,face,29,45,71,76,,42,31
1774.jpg,100,100,face,26,43,70,80,,44,37
1775.jpg,100,100,face,27,44,74,75,,47,31
1776.jpg,100,100,face,28,45,74,78,,46,33
1777.jpg,100,100,face,33,43,68,78,,35,35
1778.jpg,100,100,face,27,44,73,78,,46,34
1779.jpg,100,100,face,29,45,76,75,,47,30
178.jpg,100,100,face,25,42,77,80,,52,38
1780.jpg,100,100,face,28,43,77,76,,49,33
1781.jpg,100,100,face,24,43,75,80,,51,37
1782.jpg,100,100,face,34,43,72,78,,38,35
1783.jpg,100,100,face,29,43,72,78,,43,35
1784.jpg,100,100,face,29,42,71,77,,42,35
1785.jpg,100,100,face,29,45,76,79,,47,34
1786.jpg,100,100,face,28,41,72,80,,44,39
1787.jpg,100,100,face,27,44,73,79,,46,35
1788.jpg,100,100,face,25,45,76,80,,51,35
1789.jpg,100,100,face,28,44,74,77,,46,33
179.jpg,100,100,face,28,45,73,80,,45,35
1790.jpg,100,100,face,31,44,75,78,,44,34
1791.jpg,100,100,face,29,46,74,80,,45,34
1792.jpg,100,100,face,26,43,74,76,,48,33
1793.jpg,100,100,face,30,43,74,79,,44,36
1794.jpg,100,100,face,31,46,75,75,,44,29
1795.jpg,100,100,face,26,44,74,81,,48,37
1796.jpg,100,100,face,33,43,74,80,,41,37
1797.jpg,100,100,face,31,45,81,83,,50,38
1798.jpg,100,100,face,33,42,71,79,,38,37
1799.jpg,100,100,face,27,43,75,79,,48,36
18.jpg,100,100,face,27,43,72,75,,45,32
180.jpg,100,100,face,36,43,73,79,,37,36
1800.jpg,100,100,face,27,41,72,81,,45,40
1801.jpg,100,100,face,31,42,84,76,,53,34
1802.jpg,100,100,face,28,44,70,79,,42,35
1803.jpg,100,100,face,29,43,70,80,,41,37
1804.jpg,100,100,face,32,39,72,81,,40,42
1805.jpg,100,100,face,31,43,76,80,,45,37
1806.jpg,100,100,face,27,41,66,77,,39,36
1807.jpg,100,100,face,32,44,72,81,,40,37
1808.jpg,100,100,face,33,42,72,82,,39,40
1809.jpg,100,100,face,30,42,65,81,,35,39
181.jpg,100,100,face,27,43,75,80,,48,37
1810.jpg,100,100,face,30,42,72,79,,42,37
1811.jpg,100,100,face,29,43,74,78,,45,35
1812.jpg,100,100,face,32,44,71,82,,39,38
1813.jpg,100,100,face,30,42,72,77,,42,35
1814.jpg,100,100,face,30,41,76,76,,46,35
1815.jpg,100,100,face,26,40,73,76,,47,36
1816.jpg,100,100,face,31,43,69,80,,38,37
1817.jpg,100,100,face,30,44,70,76,,40,32
1818.jpg,100,100,face,35,44,72,77,,37,33
1819.jpg,100,100,face,29,40,77,83,,48,43
182.jpg,100,100,face,30,44,68,76,,38,32
1820.jpg,100,100,face,31,46,70,75,,39,29
1821.jpg,100,100,face,28,44,72,77,,44,33
1822.jpg,100,100,face,27,46,68,76,,41,30
1823.jpg,100,100,face,36,42,74,82,,38,40
1824.jpg,100,100,face,30,42,74,79,,44,37
1825.jpg,100,100,face,27,42,74,80,,47,38
1826.jpg,100,100,face,32,40,66,84,,34,44
1827.jpg,100,100,face,26,44,70,78,,44,34
1828.jpg,100,100,face,31,44,70,79,,39,35
1829.jpg,100,100,face,30,40,77,82,,47,42
183.jpg,100,100,face,30,43,71,80,,41,37
1830.jpg,100,100,face,33,41,72,79,,39,38
1831.jpg,100,100,face,32,43,71,76,,39,33
1832.jpg,100,100,face,32,42,71,79,,39,37
1833.jpg,100,100,face,33,44,74,76,,41,32
1834.jpg,100,100,face,32,43,72,81,,40,38
1835.jpg,100,100,face,26,41,74,81,,48,40
1836.jpg,100,100,face,31,42,74,81,,43,39
1837.jpg,100,100,face,31,43,73,77,,42,34
1838.jpg,100,100,face,30,43,70,76,,40,33
1839.jpg,100,100,face,26,42,69,76,,43,34
184.jpg,100,100,face,27,41,74,77,,47,36
1840.jpg,100,100,face,28,41,76,77,,48,36
1841.jpg,100,100,face,26,43,72,78,,46,35
1842.jpg,100,100,face,30,40,70,78,,40,38
1843.jpg,100,100,face,27,44,82,79,,55,35
1844.jpg,100,100,face,29,43,74,78,,45,35
1845.jpg,100,100,face,33,46,78,80,,45,34
1846.jpg,100,100,face,24,42,81,81,,57,39
1847.jpg,100,100,face,32,43,71,76,,39,33
1848.jpg,100,100,face,31,43,76,83,,45,40
1849.jpg,100,100,face,32,41,68,79,,36,38
185.jpg,100,100,face,28,43,75,80,,47,37
1850.jpg,100,100,face,26,43,76,78,,50,35
1851.jpg,100,100,face,29,42,73,79,,44,37
1852.jpg,100,100,face,32,44,72,81,,40,37
1853.jpg,100,100,face,26,44,74,79,,48,35
1854.jpg,100,100,face,23,42,69,76,,46,34
1855.jpg,100,100,face,29,43,71,80,,42,37
1856.jpg,100,100,face,27,45,79,79,,52,34
1857.jpg,100,100,face,28,44,75,76,,47,32
1858.jpg,100,100,face,28,43,74,78,,46,35
1859.jpg,100,100,face,30,44,72,81,,42,37
186.jpg,100,100,face,29,43,74,84,,45,41
1860.jpg,100,100,face,28,40,75,81,,47,41
1861.jpg,100,100,face,27,41,77,82,,50,41
1862.jpg,100,100,face,31,38,71,83,,40,45
1863.jpg,100,100,face,30,43,78,82,,48,39
1864.jpg,100,100,face,28,44,77,75,,49,31
1865.jpg,100,100,face,31,43,72,77,,41,34
1866.jpg,100,100,face,31,43,75,76,,44,33
1867.jpg,100,100,face,31,44,73,78,,42,34
1868.jpg,100,100,face,29,44,67,78,,38,34
1869.jpg,100,100,face,28,43,67,77,,39,34
187.jpg,100,100,face,30,42,69,77,,39,35
1870.jpg,100,100,face,32,41,72,75,,40,34
1871.jpg,100,100,face,32,43,71,79,,39,36
1872.jpg,100,100,face,32,41,70,79,,38,38
1873.jpg,100,100,face,40,39,67,89,,27,50
1874.jpg,100,100,face,28,43,74,80,,46,37
1875.jpg,100,100,face,32,42,64,78,,32,36
1876.jpg,100,100,face,31,41,68,79,,37,38
1877.jpg,100,100,face,31,44,77,77,,46,33
1878.jpg,100,100,face,30,42,70,76,,40,34
1879.jpg,100,100,face,31,42,74,79,,43,37
188.jpg,100,100,face,30,43,70,79,,40,36
1880.jpg,100,100,face,30,43,70,79,,40,36
1881.jpg,100,100,face,27,43,67,80,,40,37
1882.jpg,100,100,face,30,42,72,81,,42,39
1883.jpg,100,100,face,31,43,69,84,,38,41
1884.jpg,100,100,face,33,41,73,79,,40,38
1885.jpg,100,100,face,33,43,69,76,,36,33
1886.jpg,100,100,face,28,42,72,82,,44,40
1887.jpg,100,100,face,31,43,72,78,,41,35
1888.jpg,100,100,face,31,43,73,80,,42,37
1889.jpg,100,100,face,32,41,75,82,,43,41
189.jpg,100,100,face,31,42,75,77,,44,35
1890.jpg,100,100,face,28,42,74,81,,46,39
1891.jpg,100,100,face,29,41,73,79,,44,38
1892.jpg,100,100,face,33,42,74,82,,41,40
1893.jpg,100,100,face,28,41,76,78,,48,37
1894.jpg,100,100,face,25,41,81,80,,56,39
1895.jpg,100,100,face,30,45,71,78,,41,33
1896.jpg,100,100,face,32,44,75,85,,43,41
1897.jpg,100,100,face,26,44,74,83,,48,39
1898.jpg,100,100,face,33,43,74,82,,41,39
1899.jpg,100,100,face,31,43,73,79,,42,36
19.jpg,100,100,face,34,44,71,80,,37,36
190.jpg,100,100,face,31,42,77,83,,46,41
1900.jpg,100,100,face,30,42,73,84,,43,42
1901.jpg,100,100,face,28,45,72,86,,44,41
1902.jpg,100,100,face,32,41,75,81,,43,40
1903.jpg,100,100,face,27,42,68,80,,41,38
1904.jpg,100,100,face,25,44,71,79,,46,35
1905.jpg,100,100,face,30,43,68,76,,38,33
1906.jpg,100,100,face,29,45,65,84,,36,39
1907.jpg,100,100,face,35,42,69,80,,34,38
1908.jpg,100,100,face,29,43,73,76,,44,33
1909.jpg,100,100,face,29,43,74,82,,45,39
191.jpg,100,100,face,29,41,73,81,,44,40
1910.jpg,100,100,face,26,42,75,81,,49,39
1911.jpg,100,100,face,32,43,75,79,,43,36
1912.jpg,100,100,face,35,43,70,81,,35,38
1913.jpg,100,100,face,28,43,73,79,,45,36
1914.jpg,100,100,face,32,43,70,79,,38,36
1915.jpg,100,100,face,29,41,75,79,,46,38
1916.jpg,100,100,face,32,42,66,85,,34,43
1917.jpg,100,100,face,32,44,71,81,,39,37
1918.jpg,100,100,face,29,42,72,81,,43,39
1919.jpg,100,100,face,33,42,70,81,,37,39
192.jpg,100,100,face,32,44,71,81,,39,37
1920.jpg,100,100,face,31,44,75,78,,44,34
1921.jpg,100,100,face,28,42,71,79,,43,37
1922.jpg,100,100,face,31,41,70,82,,39,41
1923.jpg,100,100,face,27,45,76,82,,49,37
1924.jpg,100,100,face,35,40,73,81,,38,41
1925.jpg,100,100,face,31,40,71,76,,40,36
1926.jpg,100,100,face,33,43,68,78,,35,35
1927.jpg,100,100,face,33,42,69,79,,36,37
1928.jpg,100,100,face,31,43,74,78,,43,35
1929.jpg,100,100,face,36,41,71,84,,35,43
193.jpg,100,100,face,33,43,69,78,,36,35
1930.jpg,100,100,face,33,44,74,79,,41,35
1931.jpg,100,100,face,32,42,66,78,,34,36
1932.jpg,100,100,face,32,45,70,75,,38,30
1933.jpg,100,100,face,32,44,67,83,,35,39
1934.jpg,100,100,face,32,39,70,84,,38,45
1935.jpg,100,100,face,33,42,72,80,,39,38
1936.jpg,100,100,face,31,41,73,83,,42,42
1937.jpg,100,100,face,30,40,68,82,,38,42
1938.jpg,100,100,face,30,42,75,79,,45,37
1939.jpg,100,100,face,33,43,71,81,,38,38
194.jpg,100,100,face,29,44,72,81,,43,37
1940.jpg,100,100,face,29,39,66,89,,37,50
1941.jpg,100,100,face,29,42,76,76,,47,34
1942.jpg,100,100,face,31,40,68,77,,37,37
1943.jpg,100,100,face,31,44,75,79,,44,35
1944.jpg,100,100,face,26,41,73,76,,47,35
1945.jpg,100,100,face,28,46,73,79,,45,33
1946.jpg,100,100,face,28,41,70,82,,42,41
1947.jpg,100,100,face,28,42,71,79,,43,37
1948.jpg,100,100,face,28,40,79,84,,51,44
1949.jpg,100,100,face,30,42,68,83,,38,41
195.jpg,100,100,face,30,44,71,77,,41,33
1950.jpg,100,100,face,32,42,71,79,,39,37
196.jpg,100,100,face,33,39,74,81,,41,42
197.jpg,100,100,face,26,43,75,80,,49,37
198.jpg,100,100,face,29,45,80,83,,51,38
199.jpg,100,100,face,28,41,68,84,,40,43
2.jpg,100,100,face,30,41,76,85,,46,44
20.jpg,100,100,face,30,43,71,82,,41,39
200.jpg,100,100,face,28,41,68,80,,40,39
201.jpg,100,100,face,30,43,71,82,,41,39
202.jpg,100,100,face,26,41,74,80,,48,39
203.jpg,100,100,face,27,43,74,79,,47,36
204.jpg,100,100,face,29,45,71,82,,42,37
205.jpg,100,100,face,25,38,76,82,,51,44
206.jpg,100,100,face,32,42,76,81,,44,39
207.jpg,100,100,face,27,41,71,82,,44,41
208.jpg,100,100,face,25,40,77,79,,52,39
209.jpg,100,100,face,35,41,72,84,,37,43
21.jpg,100,100,face,28,39,71,83,,43,44
210.jpg,100,100,face,25,41,73,84,,48,43
211.jpg,100,100,face,29,43,71,85,,42,42
212.jpg,100,100,face,32,44,73,82,,41,38
213.jpg,100,100,face,33,42,71,87,,38,45
214.jpg,100,100,face,31,44,77,81,,46,37
215.jpg,100,100,face,36,45,76,82,,40,37
216.jpg,100,100,face,26,39,70,79,,44,40
217.jpg,100,100,face,30,42,70,79,,40,37
218.jpg,100,100,face,27,38,69,82,,42,44
219.jpg,100,100,face,30,40,72,79,,42,39
22.jpg,100,100,face,29,42,71,77,,42,35
220.jpg,100,100,face,32,42,72,82,,40,40
221.jpg,100,100,face,29,43,74,84,,45,41
222.jpg,100,100,face,30,41,70,82,,40,41
223.jpg,100,100,face,30,42,68,83,,38,41
224.jpg,100,100,face,27,41,75,79,,48,38
225.jpg,100,100,face,27,42,77,81,,50,39
226.jpg,100,100,face,30,43,72,75,,42,32
227.jpg,100,100,face,31,43,69,79,,38,36
228.jpg,100,100,face,30,44,77,79,,47,35
229.jpg,100,100,face,34,44,70,81,,36,37
23.jpg,100,100,face,27,39,68,80,,41,41
230.jpg,100,100,face,32,42,73,79,,41,37
231.jpg,100,100,face,30,42,76,79,,46,37
232.jpg,100,100,face,28,41,79,83,,51,42
233.jpg,100,100,face,28,41,74,81,,46,40
234.jpg,100,100,face,31,42,75,83,,44,41
235.jpg,100,100,face,28,41,73,79,,45,38
236.jpg,100,100,face,27,40,72,77,,45,37
237.jpg,100,100,face,30,42,70,77,,40,35
238.jpg,100,100,face,28,44,79,81,,51,37
239.jpg,100,100,face,27,42,67,75,,40,33
24.jpg,100,100,face,25,43,70,75,,45,32
240.jpg,100,100,face,30,42,73,80,,43,38
241.jpg,100,100,face,29,44,73,80,,44,36
242.jpg,100,100,face,30,43,75,79,,45,36
243.jpg,100,100,face,31,41,71,76,,40,35
244.jpg,100,100,face,29,43,73,78,,44,35
245.jpg,100,100,face,30,45,75,84,,45,39
246.jpg,100,100,face,33,44,64,79,,31,35
247.jpg,100,100,face,28,42,72,81,,44,39
248.jpg,100,100,face,29,41,75,76,,46,35
249.jpg,100,100,face,27,42,78,78,,51,36
25.jpg,100,100,face,25,43,78,79,,53,36
250.jpg,100,100,face,29,44,75,79,,46,35
251.jpg,100,100,face,29,43,74,74,,45,31
252.jpg,100,100,face,31,46,70,78,,39,32
253.jpg,100,100,face,29,41,68,80,,39,39
254.jpg,100,100,face,30,44,67,78,,37,34
255.jpg,100,100,face,28,43,68,81,,40,38
256.jpg,100,100,face,28,41,76,79,,48,38
257.jpg,100,100,face,25,43,74,81,,49,38
258.jpg,100,100,face,31,42,73,76,,42,34
259.jpg,100,100,face,28,41,73,78,,45,37
26.jpg,100,100,face,33,43,69,76,,36,33
260.jpg,100,100,face,32,44,72,79,,40,35
261.jpg,100,100,face,32,44,71,80,,39,36
262.jpg,100,100,face,30,41,75,86,,45,45
263.jpg,100,100,face,24,42,75,78,,51,36
264.jpg,100,100,face,33,43,73,83,,40,40
265.jpg,100,100,face,24,40,76,87,,52,47
266.jpg,100,100,face,29,43,68,79,,39,36
267.jpg,100,100,face,29,40,75,81,,46,41
268.jpg,100,100,face,32,40,72,79,,40,39
269.jpg,100,100,face,31,44,70,81,,39,37
27.jpg,100,100,face,29,41,72,79,,43,38
270.jpg,100,100,face,24,40,77,83,,53,43
271.jpg,100,100,face,28,44,74,82,,46,38
272.jpg,100,100,face,31,42,70,80,,39,38
273.jpg,100,100,face,28,42,78,86,,50,44
274.jpg,100,100,face,29,42,73,80,,44,38
275.jpg,100,100,face,29,43,68,77,,39,34
276.jpg,100,100,face,27,44,75,83,,48,39
277.jpg,100,100,face,30,44,74,80,,44,36
278.jpg,100,100,face,32,43,70,80,,38,37
279.jpg,100,100,face,27,42,76,79,,49,37
28.jpg,100,100,face,30,44,72,81,,42,37
280.jpg,100,100,face,30,45,72,88,,42,43
281.jpg,100,100,face,31,47,75,81,,44,34
282.jpg,100,100,face,28,42,70,76,,42,34
283.jpg,100,100,face,30,44,71,81,,41,37
284.jpg,100,100,face,31,43,62,81,,31,38
285.jpg,100,100,face,36,41,68,80,,32,39
286.jpg,100,100,face,26,40,74,80,,48,40
287.jpg,100,100,face,28,42,75,78,,47,36
288.jpg,100,100,face,31,43,74,78,,43,35
289.jpg,100,100,face,28,43,66,77,,38,34
29.jpg,100,100,face,37,46,70,80,,33,34
290.jpg,100,100,face,29,41,73,76,,44,35
291.jpg,100,100,face,29,43,73,79,,44,36
292.jpg,100,100,face,31,45,70,78,,39,33
293.jpg,100,100,face,31,44,77,81,,46,37
294.jpg,100,100,face,32,46,76,77,,44,31
295.jpg,100,100,face,32,42,70,79,,38,37
296.jpg,100,100,face,30,40,71,83,,41,43
297.jpg,100,100,face,33,38,65,80,,32,42
298.jpg,100,100,face,37,43,70,78,,33,35
299.jpg,100,100,face,32,43,70,81,,38,38
3.jpg,100,100,face,29,44,72,74,,43,30
30.jpg,100,100,face,31,44,77,75,,46,31
300.jpg,100,100,face,33,42,74,78,,41,36
301.jpg,100,100,face,31,43,73,81,,42,38
302.jpg,100,100,face,37,44,74,84,,37,40
303.jpg,100,100,face,28,44,75,84,,47,40
304.jpg,100,100,face,29,43,78,79,,49,36
305.jpg,100,100,face,28,44,71,79,,43,35
306.jpg,100,100,face,30,45,75,79,,45,34
307.jpg,100,100,face,29,43,74,77,,45,34
308.jpg,100,100,face,29,44,71,82,,42,38
309.jpg,100,100,face,32,43,73,74,,41,31
31.jpg,100,100,face,31,42,67,84,,36,42
310.jpg,100,100,face,28,43,75,79,,47,36
311.jpg,100,100,face,29,45,78,78,,49,33
312.jpg,100,100,face,27,41,69,75,,42,34
313.jpg,100,100,face,30,43,78,77,,48,34
314.jpg,100,100,face,31,43,73,75,,42,32
315.jpg,100,100,face,28,45,76,79,,48,34
316.jpg,100,100,face,27,42,71,76,,44,34
317.jpg,100,100,face,31,46,70,74,,39,28
318.jpg,100,100,face,29,43,70,78,,41,35
319.jpg,100,100,face,32,42,68,78,,36,36
32.jpg,100,100,face,32,43,65,82,,33,39
320.jpg,100,100,face,32,44,67,82,,35,38
321.jpg,100,100,face,28,41,74,79,,46,38
322.jpg,100,100,face,31,41,69,78,,38,37
323.jpg,100,100,face,27,40,70,79,,43,39
324.jpg,100,100,face,28,39,69,80,,41,41
325.jpg,100,100,face,32,42,68,79,,36,37
326.jpg,100,100,face,33,41,68,83,,35,42
327.jpg,100,100,face,29,42,72,77,,43,35
328.jpg,100,100,face,29,42,68,77,,39,35
329.jpg,100,100,face,25,43,76,82,,51,39
33.jpg,100,100,face,31,44,73,79,,42,35
330.jpg,100,100,face,30,45,73,77,,43,32
331.jpg,100,100,face,32,46,75,81,,43,35
332.jpg,100,100,face,30,40,71,78,,41,38
333.jpg,100,100,face,30,40,74,80,,44,40
334.jpg,100,100,face,30,43,73,80,,43,37
335.jpg,100,100,face,31,42,72,81,,41,39
336.jpg,100,100,face,30,44,78,83,,48,39
337.jpg,100,100,face,32,41,74,79,,42,38
338.jpg,100,100,face,29,45,70,75,,41,30
339.jpg,100,100,face,32,45,71,77,,39,32
34.jpg,100,100,face,31,43,70,77,,39,34
340.jpg,100,100,face,31,46,75,80,,44,34
341.jpg,100,100,face,28,41,71,79,,43,38
342.jpg,100,100,face,32,45,76,78,,44,33
343.jpg,100,100,face,30,42,74,78,,44,36
344.jpg,100,100,face,32,44,67,77,,35,33
345.jpg,100,100,face,31,37,72,78,,41,41
346.jpg,100,100,face,33,42,73,81,,40,39
347.jpg,100,100,face,31,42,73,88,,42,46
348.jpg,100,100,face,31,43,71,81,,40,38
349.jpg,100,100,face,27,43,75,79,,48,36
35.jpg,100,100,face,28,44,71,81,,43,37
350.jpg,100,100,face,33,42,75,86,,42,44
351.jpg,100,100,face,25,44,76,82,,51,38
352.jpg,100,100,face,25,44,76,87,,51,43
353.jpg,100,100,face,29,43,73,87,,44,44
354.jpg,100,100,face,33,40,72,86,,39,46
355.jpg,100,100,face,28,41,74,85,,46,44
356.jpg,100,100,face,31,41,69,89,,38,48
357.jpg,100,100,face,33,42,67,87,,34,45
358.jpg,100,100,face,27,43,80,87,,53,44
359.jpg,100,100,face,30,41,78,80,,48,39
36.jpg,100,100,face,31,43,77,84,,46,41
360.jpg,100,100,face,35,43,73,87,,38,44
361.jpg,100,100,face,29,43,72,83,,43,40
362.jpg,100,100,face,26,42,71,87,,45,45
363.jpg,100,100,face,28,41,71,83,,43,42
364.jpg,100,100,face,24,42,64,85,,40,43
365.jpg,100,100,face,30,41,70,90,,40,49
366.jpg,100,100,face,28,40,76,81,,48,41
367.jpg,100,100,face,26,41,76,82,,50,41
368.jpg,100,100,face,30,40,73,87,,43,47
369.jpg,100,100,face,30,40,74,81,,44,41
37.jpg,100,100,face,26,43,76,83,,50,40
370.jpg,100,100,face,27,43,69,84,,42,41
371.jpg,100,100,face,30,43,77,79,,47,36
372.jpg,100,100,face,28,41,75,83,,47,42
373.jpg,100,100,face,27,41,72,75,,45,34
374.jpg,100,100,face,29,43,71,78,,42,35
375.jpg,100,100,face,24,41,75,76,,51,35
376.jpg,100,100,face,29,38,79,80,,50,42
377.jpg,100,100,face,32,43,71,80,,39,37
378.jpg,100,100,face,30,42,77,79,,47,37
379.jpg,100,100,face,28,42,73,77,,45,35
38.jpg,100,100,face,29,42,78,79,,49,37
380.jpg,100,100,face,24,41,72,79,,48,38
381.jpg,100,100,face,31,43,71,78,,40,35
382.jpg,100,100,face,31,42,74,79,,43,37
383.jpg,100,100,face,30,44,71,79,,41,35
384.jpg,100,100,face,27,42,75,78,,48,36
385.jpg,100,100,face,29,43,76,81,,47,38
386.jpg,100,100,face,29,45,75,79,,46,34
387.jpg,100,100,face,29,43,77,78,,48,35
388.jpg,100,100,face,33,42,79,78,,46,36
389.jpg,100,100,face,33,42,72,82,,39,40
39.jpg,100,100,face,31,43,70,81,,39,38
390.jpg,100,100,face,31,41,69,78,,38,37
391.jpg,100,100,face,29,42,73,81,,44,39
392.jpg,100,100,face,30,45,74,80,,44,35
393.jpg,100,100,face,30,42,73,78,,43,36
394.jpg,100,100,face,25,42,73,78,,48,36
395.jpg,100,100,face,31,44,71,80,,40,36
396.jpg,100,100,face,26,42,72,80,,46,38
397.jpg,100,100,face,29,44,70,77,,41,33
398.jpg,100,100,face,29,44,66,78,,37,34
399.jpg,100,100,face,27,45,74,81,,47,36
4.jpg,100,100,face,29,44,76,78,,47,34
40.jpg,100,100,face,33,46,71,81,,38,35
400.jpg,100,100,face,32,41,70,79,,38,38
401.jpg,100,100,face,31,41,77,78,,46,37
402.jpg,100,100,face,28,43,65,83,,37,40
403.jpg,100,100,face,29,42,72,81,,43,39
404.jpg,100,100,face,31,46,74,79,,43,33
405.jpg,100,100,face,31,44,70,79,,39,35
406.jpg,100,100,face,31,46,75,82,,44,36
407.jpg,100,100,face,30,37,66,79,,36,42
408.jpg,100,100,face,25,44,73,81,,48,37
409.jpg,100,100,face,24,41,81,79,,57,38
41.jpg,100,100,face,28,43,79,79,,51,36
410.jpg,100,100,face,28,43,78,77,,50,34
411.jpg,100,100,face,29,39,72,77,,43,38
412.jpg,100,100,face,27,43,80,81,,53,38
413.jpg,100,100,face,31,41,75,81,,44,40
414.jpg,100,100,face,25,43,82,81,,57,38
415.jpg,100,100,face,24,44,74,78,,50,34
416.jpg,100,100,face,25,45,81,80,,56,35
417.jpg,100,100,face,24,42,81,82,,57,40
418.jpg,100,100,face,28,44,77,83,,49,39
419.jpg,100,100,face,26,43,79,79,,53,36
42.jpg,100,100,face,25,41,82,83,,57,42
420.jpg,100,100,face,28,42,76,82,,48,40
421.jpg,100,100,face,29,45,75,79,,46,34
422.jpg,100,100,face,24,41,72,80,,48,39
423.jpg,100,100,face,26,43,69,81,,43,38
424.jpg,100,100,face,27,43,70,88,,43,45
425.jpg,100,100,face,28,43,70,86,,42,43
426.jpg,100,100,face,29,43,80,84,,51,41
427.jpg,100,100,face,32,45,78,85,,46,40
428.jpg,100,100,face,26,45,89,89,,63,44
429.jpg,100,100,face,29,40,78,84,,49,44
43.jpg,100,100,face,26,45,76,78,,50,33
430.jpg,100,100,face,25,41,65,86,,40,45
431.jpg,100,100,face,26,44,80,85,,54,41
432.jpg,100,100,face,29,42,69,80,,40,38
433.jpg,100,100,face,30,44,79,84,,49,40
434.jpg,100,100,face,27,43,77,84,,50,41
435.jpg,100,100,face,27,43,76,85,,49,42
436.jpg,100,100,face,23,41,77,83,,54,42
437.jpg,100,100,face,24,41,79,84,,55,43
438.jpg,100,100,face,25,42,70,78,,45,36
439.jpg,100,100,face,22,42,76,81,,54,39
44.jpg,100,100,face,35,42,84,87,,49,45
440.jpg,100,100,face,26,43,83,79,,57,36
441.jpg,100,100,face,28,43,79,78,,51,35
442.jpg,100,100,face,24,42,69,77,,45,35
443.jpg,100,100,face,25,44,81,85,,56,41
444.jpg,100,100,face,30,43,78,82,,48,39
445.jpg,100,100,face,26,43,71,79,,45,36
446.jpg,100,100,face,31,41,75,83,,44,42
447.jpg,100,100,face,31,44,77,81,,46,37
448.jpg,100,100,face,28,44,69,79,,41,35
449.jpg,100,100,face,30,43,70,80,,40,37
45.jpg,100,100,face,33,44,68,79,,35,35
450.jpg,100,100,face,31,43,70,80,,39,37
451.jpg,100,100,face,30,41,73,84,,43,43
452.jpg,100,100,face,29,46,73,83,,44,37
453.jpg,100,100,face,32,45,74,78,,42,33
454.jpg,100,100,face,27,40,72,81,,45,41
455.jpg,100,100,face,30,44,76,83,,46,39
456.jpg,100,100,face,31,43,68,81,,37,38
457.jpg,100,100,face,29,43,66,79,,37,36
458.jpg,100,100,face,26,43,76,77,,50,34
459.jpg,100,100,face,28,43,74,81,,46,38
46.jpg,100,100,face,31,43,67,85,,36,42
460.jpg,100,100,face,30,42,70,79,,40,37
461.jpg,100,100,face,32,43,73,82,,41,39
462.jpg,100,100,face,29,41,74,80,,45,39
463.jpg,100,100,face,33,40,75,82,,42,42
464.jpg,100,100,face,33,44,78,78,,45,34
465.jpg,100,100,face,30,42,76,80,,46,38
466.jpg,100,100,face,29,43,76,82,,47,39
467.jpg,100,100,face,29,44,74,76,,45,32
468.jpg,100,100,face,27,43,74,78,,47,35
469.jpg,100,100,face,35,43,76,84,,41,41
47.jpg,100,100,face,28,40,69,82,,41,42
470.jpg,100,100,face,27,41,77,78,,50,37
471.jpg,100,100,face,27,44,72,78,,45,34
472.jpg,100,100,face,30,44,80,83,,50,39
473.jpg,100,100,face,33,44,76,80,,43,36
474.jpg,100,100,face,28,39,70,78,,42,39
475.jpg,100,100,face,20,42,77,83,,57,41
476.jpg,100,100,face,30,44,75,77,,45,33
477.jpg,100,100,face,31,42,71,77,,40,35
478.jpg,100,100,face,28,42,75,79,,47,37
479.jpg,100,100,face,28,40,70,75,,42,35
48.jpg,100,100,face,27,43,72,76,,45,33
480.jpg,100,100,face,31,43,66,79,,35,36
481.jpg,100,100,face,29,42,73,77,,44,35
482.jpg,100,100,face,30,42,68,78,,38,36
483.jpg,100,100,face,34,41,72,80,,38,39
484.jpg,100,100,face,35,41,71,79,,36,38
485.jpg,100,100,face,32,42,73,78,,41,36
486.jpg,100,100,face,31,41,71,77,,40,36
487.jpg,100,100,face,29,44,75,78,,46,34
488.jpg,100,100,face,34,44,73,81,,39,37
489.jpg,100,100,face,33,43,71,77,,38,34
49.jpg,100,100,face,30,44,70,81,,40,37
490.jpg,100,100,face,27,40,71,80,,44,40
491.jpg,100,100,face,27,43,72,80,,45,37
492.jpg,100,100,face,30,42,67,85,,37,43
493.jpg,100,100,face,29,42,70,75,,41,33
494.jpg,100,100,face,29,44,68,78,,39,34
495.jpg,100,100,face,34,41,71,79,,37,38
496.jpg,100,100,face,27,41,71,76,,44,35
497.jpg,100,100,face,25,44,75,79,,50,35
498.jpg,100,100,face,31,45,73,81,,42,36
499.jpg,100,100,face,27,43,71,74,,44,31
5.jpg,100,100,face,30,43,76,79,,46,36
50.jpg,100,100,face,40,43,74,85,,34,42
500.jpg,100,100,face,30,44,76,78,,46,34
501.jpg,100,100,face,28,44,74,81,,46,37
502.jpg,100,100,face,29,40,75,81,,46,41
503.jpg,100,100,face,34,43,75,82,,41,39
504.jpg,100,100,face,28,43,78,81,,50,38
505.jpg,100,100,face,27,42,77,79,,50,37
506.jpg,100,100,face,32,43,75,78,,43,35
507.jpg,100,100,face,27,39,74,77,,47,38
508.jpg,100,100,face,28,42,74,81,,46,39
509.jpg,100,100,face,36,41,76,81,,40,40
51.jpg,100,100,face,32,40,72,76,,40,36
510.jpg,100,100,face,33,43,80,79,,47,36
511.jpg,100,100,face,30,43,74,79,,44,36
512.jpg,100,100,face,27,42,81,79,,54,37
513.jpg,100,100,face,33,46,72,80,,39,34
514.jpg,100,100,face,24,43,73,76,,49,33
515.jpg,100,100,face,28,45,76,77,,48,32
516.jpg,100,100,face,30,43,78,73,,48,30
517.jpg,100,100,face,29,41,74,79,,45,38
518.jpg,100,100,face,29,43,67,74,,38,31
519.jpg,100,100,face,30,40,71,81,,41,41
52.jpg,100,100,face,28,43,66,76,,38,33
520.jpg,100,100,face,27,42,71,81,,44,39
521.jpg,100,100,face,30,41,70,77,,40,36
522.jpg,100,100,face,29,44,73,79,,44,35
523.jpg,100,100,face,25,42,75,81,,50,39
524.jpg,100,100,face,24,42,73,74,,49,32
525.jpg,100,100,face,29,44,74,78,,45,34
526.jpg,100,100,face,31,44,73,78,,42,34
527.jpg,100,100,face,28,42,69,76,,41,34
528.jpg,100,100,face,29,43,78,80,,49,37
529.jpg,100,100,face,27,43,66,78,,39,35
53.jpg,100,100,face,31,42,72,78,,41,36
530.jpg,100,100,face,26,43,73,77,,47,34
531.jpg,100,100,face,24,42,74,78,,50,36
532.jpg,100,100,face,27,42,73,79,,46,37
533.jpg,100,100,face,29,44,72,78,,43,34
534.jpg,100,100,face,28,43,73,76,,45,33
535.jpg,100,100,face,27,42,72,79,,45,37
536.jpg,100,100,face,30,42,68,77,,38,35
537.jpg,100,100,face,30,44,72,77,,42,33
538.jpg,100,100,face,28,41,67,78,,39,37
539.jpg,100,100,face,28,39,75,75,,47,36
54.jpg,100,100,face,31,40,72,79,,41,39
540.jpg,100,100,face,30,42,69,78,,39,36
541.jpg,100,100,face,30,42,70,76,,40,34
542.jpg,100,100,face,34,40,72,80,,38,40
543.jpg,100,100,face,33,41,69,79,,36,38
544.jpg,100,100,face,32,41,74,79,,42,38
545.jpg,100,100,face,32,41,73,76,,41,35
546.jpg,100,100,face,31,45,76,80,,45,35
547.jpg,100,100,face,29,42,70,75,,41,33
548.jpg,100,100,face,31,44,73,77,,42,33
549.jpg,100,100,face,26,42,74,77,,48,35
55.jpg,100,100,face,28,42,72,81,,44,39
550.jpg,100,100,face,30,42,71,75,,41,33
551.jpg,100,100,face,33,43,70,78,,37,35
552.jpg,100,100,face,28,43,74,80,,46,37
553.jpg,100,100,face,32,44,70,76,,38,32
554.jpg,100,100,face,27,42,75,78,,48,36
555.jpg,100,100,face,33,43,71,76,,38,33
556.jpg,100,100,face,29,45,71,78,,42,33
557.jpg,100,100,face,32,44,71,76,,39,32
558.jpg,100,100,face,31,44,70,76,,39,32
559.jpg,100,100,face,29,44,73,79,,44,35
56.jpg,100,100,face,29,43,73,76,,44,33
560.jpg,100,100,face,31,45,70,80,,39,35
561.jpg,100,100,face,28,44,74,83,,46,39
562.jpg,100,100,face,29,43,75,78,,46,35
563.jpg,100,100,face,29,41,77,78,,48,37
564.jpg,100,100,face,29,43,75,82,,46,39
565.jpg,100,100,face,29,41,74,76,,45,35
566.jpg,100,100,face,31,41,75,81,,44,40
567.jpg,100,100,face,29,42,74,77,,45,35
568.jpg,100,100,face,25,40,72,81,,47,41
569.jpg,100,100,face,29,44,72,79,,43,35
57.jpg,100,100,face,25,41,72,77,,47,36
570.jpg,100,100,face,27,43,77,80,,50,37
571.jpg,100,100,face,29,43,79,82,,50,39
572.jpg,100,100,face,31,42,78,80,,47,38
573.jpg,100,100,face,29,42,78,83,,49,41
574.jpg,100,100,face,24,42,76,79,,52,37
575.jpg,100,100,face,31,42,75,78,,44,36
576.jpg,100,100,face,28,39,66,78,,38,39
577.jpg,100,100,face,31,41,70,80,,39,39
578.jpg,100,100,face,32,43,67,79,,35,36
579.jpg,100,100,face,27,41,66,77,,39,36
58.jpg,100,100,face,28,42,70,75,,42,33
580.jpg,100,100,face,33,43,70,78,,37,35
581.jpg,100,100,face,30,38,70,82,,40,44
582.jpg,100,100,face,31,41,72,79,,41,38
583.jpg,100,100,face,27,40,72,81,,45,41
584.jpg,100,100,face,30,43,72,80,,42,37
585.jpg,100,100,face,32,44,74,81,,42,37
586.jpg,100,100,face,26,36,71,83,,45,47
587.jpg,100,100,face,29,41,74,85,,45,44
588.jpg,100,100,face,28,43,68,83,,40,40
589.jpg,100,100,face,28,42,76,84,,48,42
59.jpg,100,100,face,28,41,71,80,,43,39
590.jpg,100,100,face,30,41,73,80,,43,39
591.jpg,100,100,face,28,41,73,79,,45,38
592.jpg,100,100,face,29,43,72,82,,43,39
593.jpg,100,100,face,28,43,77,86,,49,43
594.jpg,100,100,face,33,41,80,84,,47,43
595.jpg,100,100,face,26,43,77,80,,51,37
596.jpg,100,100,face,28,43,73,76,,45,33
597.jpg,100,100,face,26,40,65,76,,39,36
598.jpg,100,100,face,29,41,69,80,,40,39
599.jpg,100,100,face,26,40,71,80,,45,40
6.jpg,100,100,face,26,40,69,78,,43,38
60.jpg,100,100,face,27,41,70,81,,43,40
600.jpg,100,100,face,26,40,68,76,,42,36
601.jpg,100,100,face,31,43,68,78,,37,35
602.jpg,100,100,face,29,41,68,77,,39,36
603.jpg,100,100,face,29,41,75,82,,46,41
604.jpg,100,100,face,34,43,71,78,,37,35
605.jpg,100,100,face,32,43,68,82,,36,39
606.jpg,100,100,face,30,40,73,79,,43,39
607.jpg,100,100,face,28,42,71,79,,43,37
608.jpg,100,100,face,33,43,77,79,,44,36
609.jpg,100,100,face,30,43,76,78,,46,35
61.jpg,100,100,face,30,41,65,80,,35,39
610.jpg,100,100,face,28,44,70,78,,42,34
611.jpg,100,100,face,29,40,72,76,,43,36
612.jpg,100,100,face,30,42,74,78,,44,36
613.jpg,100,100,face,31,41,72,84,,41,43
614.jpg,100,100,face,29,43,70,82,,41,39
615.jpg,100,100,face,28,45,73,79,,45,34
616.jpg,100,100,face,27,41,78,80,,51,39
617.jpg,100,100,face,26,41,76,77,,50,36
618.jpg,100,100,face,27,42,75,78,,48,36
619.jpg,100,100,face,29,42,77,81,,48,39
62.jpg,100,100,face,33,43,74,77,,41,34
620.jpg,100,100,face,27,43,75,80,,48,37
621.jpg,100,100,face,29,40,69,80,,40,40
622.jpg,100,100,face,27,40,74,77,,47,37
623.jpg,100,100,face,28,42,75,78,,47,36
624.jpg,100,100,face,36,43,73,78,,37,35
625.jpg,100,100,face,28,42,78,80,,50,38
626.jpg,100,100,face,28,40,81,81,,53,41
627.jpg,100,100,face,29,41,70,79,,41,38
628.jpg,100,100,face,28,43,74,77,,46,34
629.jpg,100,100,face,26,44,76,82,,50,38
63.jpg,100,100,face,29,39,71,82,,42,43
630.jpg,100,100,face,25,38,77,73,,52,35
631.jpg,100,100,face,29,40,69,73,,40,33
632.jpg,100,100,face,33,42,80,88,,47,46
633.jpg,100,100,face,33,41,70,76,,37,35
634.jpg,100,100,face,31,42,74,78,,43,36
635.jpg,100,100,face,29,42,73,81,,44,39
636.jpg,100,100,face,28,43,72,77,,44,34
637.jpg,100,100,face,30,42,71,79,,41,37
638.jpg,100,100,face,31,42,70,77,,39,35
639.jpg,100,100,face,30,42,72,79,,42,37
64.jpg,100,100,face,31,43,70,78,,39,35
640.jpg,100,100,face,32,46,76,77,,44,31
641.jpg,100,100,face,29,40,73,81,,44,41
642.jpg,100,100,face,30,43,75,82,,45,39
643.jpg,100,100,face,29,40,70,79,,41,39
644.jpg,100,100,face,30,41,74,80,,44,39
645.jpg,100,100,face,25,41,74,78,,49,37
646.jpg,100,100,face,28,45,79,79,,51,34
647.jpg,100,100,face,26,42,79,82,,53,40
648.jpg,100,100,face,28,45,77,80,,49,35
649.jpg,100,100,face,17,36,86,81,,69,45
65.jpg,100,100,face,30,41,70,81,,40,40
650.jpg,100,100,face,27,42,74,79,,47,37
651.jpg,100,100,face,30,43,69,78,,39,35
652.jpg,100,100,face,33,39,72,79,,39,40
653.jpg,100,100,face,33,41,70,82,,37,41
654.jpg,100,100,face,24,41,76,80,,52,39
655.jpg,100,100,face,28,42,73,78,,45,36
656.jpg,100,100,face,30,43,69,78,,39,35
657.jpg,100,100,face,28,44,76,82,,48,38
658.jpg,100,100,face,32,41,71,78,,39,37
659.jpg,100,100,face,26,41,79,76,,53,35
66.jpg,100,100,face,31,40,65,86,,34,46
660.jpg,100,100,face,29,41,70,78,,41,37
661.jpg,100,100,face,32,43,74,79,,42,36
662.jpg,100,100,face,32,43,69,78,,37,35
663.jpg,100,100,face,32,44,71,79,,39,35
664.jpg,100,100,face,31,43,73,78,,42,35
665.jpg,100,100,face,29,43,72,80,,43,37
666.jpg,100,100,face,29,43,74,78,,45,35
667.jpg,100,100,face,30,44,69,80,,39,36
668.jpg,100,100,face,31,43,76,75,,45,32
669.jpg,100,100,face,32,45,72,77,,40,32
67.jpg,100,100,face,33,42,71,80,,38,38
670.jpg,100,100,face,33,43,71,76,,38,33
671.jpg,100,100,face,29,43,70,76,,41,33
672.jpg,100,100,face,32,43,70,78,,38,35
673.jpg,100,100,face,34,42,66,80,,32,38
674.jpg,100,100,face,34,42,65,78,,31,36
675.jpg,100,100,face,31,43,70,75,,39,32
676.jpg,100,100,face,34,43,69,79,,35,36
677.jpg,100,100,face,35,47,68,81,,33,34
678.jpg,100,100,face,32,41,66,75,,34,34
679.jpg,100,100,face,31,43,70,81,,39,38
68.jpg,100,100,face,32,44,70,81,,38,37
680.jpg,100,100,face,27,41,70,78,,43,37
681.jpg,100,100,face,32,43,71,77,,39,34
682.jpg,100,100,face,29,43,67,81,,38,38
683.jpg,100,100,face,34,44,68,76,,34,32
684.jpg,100,100,face,31,44,69,81,,38,37
685.jpg,100,100,face,35,45,70,79,,35,34
686.jpg,100,100,face,30,42,74,80,,44,38
687.jpg,100,100,face,31,43,72,81,,41,38
688.jpg,100,100,face,33,42,69,76,,36,34
689.jpg,100,100,face,30,44,72,76,,42,32
69.jpg,100,100,face,28,42,74,79,,46,37
690.jpg,100,100,face,30,40,73,79,,43,39
691.jpg,100,100,face,27,44,72,78,,45,34
692.jpg,100,100,face,29,44,70,75,,41,31
693.jpg,100,100,face,30,44,75,76,,45,32
694.jpg,100,100,face,22,41,71,81,,49,40
695.jpg,100,100,face,28,46,72,79,,44,33
696.jpg,100,100,face,27,44,69,86,,42,42
697.jpg,100,100,face,27,43,72,77,,45,34
698.jpg,100,100,face,33,41,73,78,,40,37
699.jpg,100,100,face,30,44,71,81,,41,37
7.jpg,100,100,face,30,41,68,80,,38,39
70.jpg,100,100,face,31,43,73,77,,42,34
700.jpg,100,100,face,27,42,74,78,,47,36
701.jpg,100,100,face,33,44,76,80,,43,36
702.jpg,100,100,face,33,42,72,81,,39,39
703.jpg,100,100,face,34,40,68,78,,34,38
704.jpg,100,100,face,31,42,72,82,,41,40
705.jpg,100,100,face,30,42,67,79,,37,37
706.jpg,100,100,face,30,43,66,82,,36,39
707.jpg,100,100,face,27,43,71,81,,44,38
708.jpg,100,100,face,21,42,69,79,,48,37
709.jpg,100,100,face,29,43,70,81,,41,38
71.jpg,100,100,face,27,40,65,74,,38,34
710.jpg,100,100,face,31,43,72,78,,41,35
711.jpg,100,100,face,34,41,72,82,,38,41
712.jpg,100,100,face,31,45,66,76,,35,31
713.jpg,100,100,face,28,44,72,80,,44,36
714.jpg,100,100,face,34,43,72,81,,38,38
715.jpg,100,100,face,33,44,68,79,,35,35
716.jpg,100,100,face,34,45,66,79,,32,34
717.jpg,100,100,face,30,42,70,79,,40,37
718.jpg,100,100,face,32,42,66,79,,34,37
719.jpg,100,100,face,30,41,74,76,,44,35
72.jpg,100,100,face,30,44,72,79,,42,35
720.jpg,100,100,face,29,43,69,78,,40,35
721.jpg,100,100,face,32,43,68,80,,36,37
722.jpg,100,100,face,30,45,69,78,,39,33
723.jpg,100,100,face,29,45,71,79,,42,34
724.jpg,100,100,face,26,44,71,76,,45,32
725.jpg,100,100,face,31,44,68,76,,37,32
726.jpg,100,100,face,34,42,69,81,,35,39
727.jpg,100,100,face,29,44,73,80,,44,36
728.jpg,100,100,face,31,45,70,78,,39,33
729.jpg,100,100,face,26,42,75,82,,49,40
73.jpg,100,100,face,28,42,69,76,,41,34
730.jpg,100,100,face,30,42,72,74,,42,32
731.jpg,100,100,face,29,44,72,72,,43,28
732.jpg,100,100,face,27,46,69,73,,42,27
733.jpg,100,100,face,28,44,76,82,,48,38
734.jpg,100,100,face,25,44,72,79,,47,35
735.jpg,100,100,face,29,44,76,79,,47,35
736.jpg,100,100,face,25,42,74,80,,49,38
737.jpg,100,100,face,31,42,70,79,,39,37
738.jpg,100,100,face,33,41,71,77,,38,36
739.jpg,100,100,face,28,43,67,81,,39,38
74.jpg,100,100,face,31,44,74,79,,43,35
740.jpg,100,100,face,30,40,67,77,,37,37
741.jpg,100,100,face,30,44,70,76,,40,32
742.jpg,100,100,face,30,43,69,77,,39,34
743.jpg,100,100,face,32,41,64,78,,32,37
744.jpg,100,100,face,29,40,72,81,,43,41
745.jpg,100,100,face,32,45,71,79,,39,34
746.jpg,100,100,face,28,43,74,82,,46,39
747.jpg,100,100,face,33,46,68,76,,35,30
748.jpg,100,100,face,31,45,72,78,,41,33
749.jpg,100,100,face,29,41,72,81,,43,40
75.jpg,100,100,face,34,42,74,80,,40,38
750.jpg,100,100,face,30,42,73,78,,43,36
751.jpg,100,100,face,30,43,70,77,,40,34
752.jpg,100,100,face,31,43,64,75,,33,32
753.jpg,100,100,face,28,45,73,78,,45,33
754.jpg,100,100,face,34,46,73,83,,39,37
755.jpg,100,100,face,29,41,74,81,,45,40
756.jpg,100,100,face,31,43,67,81,,36,38
757.jpg,100,100,face,29,41,70,74,,41,33
758.jpg,100,100,face,33,38,64,79,,31,41
759.jpg,100,100,face,30,45,72,82,,42,37
76.jpg,100,100,face,30,39,69,80,,39,41
760.jpg,100,100,face,33,42,74,83,,41,41
761.jpg,100,100,face,29,42,75,81,,46,39
762.jpg,100,100,face,26,41,73,79,,47,38
763.jpg,100,100,face,35,43,69,82,,34,39
764.jpg,100,100,face,29,41,75,81,,46,40
765.jpg,100,100,face,33,45,69,78,,36,33
766.jpg,100,100,face,28,43,73,79,,45,36
767.jpg,100,100,face,33,44,70,76,,37,32
768.jpg,100,100,face,29,43,72,82,,43,39
769.jpg,100,100,face,31,41,68,79,,37,38
77.jpg,100,100,face,29,46,74,78,,45,32
770.jpg,100,100,face,33,45,72,78,,39,33
771.jpg,100,100,face,32,44,71,79,,39,35
772.jpg,100,100,face,29,43,75,82,,46,39
773.jpg,100,100,face,28,43,69,77,,41,34
774.jpg,100,100,face,34,41,69,81,,35,40
775.jpg,100,100,face,34,45,69,78,,35,33
776.jpg,100,100,face,34,45,68,76,,34,31
777.jpg,100,100,face,32,44,71,76,,39,32
778.jpg,100,100,face,28,43,67,74,,39,31
779.jpg,100,100,face,30,45,70,80,,40,35
78.jpg,100,100,face,32,45,74,82,,42,37
780.jpg,100,100,face,34,44,69,79,,35,35
781.jpg,100,100,face,31,44,69,76,,38,32
782.jpg,100,100,face,32,43,71,77,,39,34
783.jpg,100,100,face,31,43,71,76,,40,33
784.jpg,100,100,face,30,43,74,77,,44,34
785.jpg,100,100,face,23,41,64,80,,41,39
786.jpg,100,100,face,27,43,71,79,,44,36
787.jpg,100,100,face,31,44,72,77,,41,33
788.jpg,100,100,face,31,44,70,81,,39,37
789.jpg,100,100,face,27,40,74,78,,47,38
79.jpg,100,100,face,34,42,69,81,,35,39
790.jpg,100,100,face,30,43,67,84,,37,41
791.jpg,100,100,face,24,40,75,79,,51,39
792.jpg,100,100,face,31,45,71,76,,40,31
793.jpg,100,100,face,31,44,72,79,,41,35
794.jpg,100,100,face,33,41,74,79,,41,38
795.jpg,100,100,face,31,41,68,80,,37,39
796.jpg,100,100,face,31,45,69,82,,38,37
797.jpg,100,100,face,32,43,71,76,,39,33
798.jpg,100,100,face,32,45,70,79,,38,34
799.jpg,100,100,face,27,42,72,81,,45,39
8.jpg,100,100,face,31,44,74,80,,43,36
80.jpg,100,100,face,31,44,71,76,,40,32
800.jpg,100,100,face,29,43,77,82,,48,39
801.jpg,100,100,face,27,41,72,78,,45,37
802.jpg,100,100,face,30,38,76,80,,46,42
803.jpg,100,100,face,32,44,72,81,,40,37
804.jpg,100,100,face,29,44,77,80,,48,36
805.jpg,100,100,face,27,43,75,78,,48,35
806.jpg,100,100,face,30,44,69,82,,39,38
807.jpg,100,100,face,27,44,76,83,,49,39
808.jpg,100,100,face,35,42,72,80,,37,38
809.jpg,100,100,face,32,44,76,82,,44,38
81.jpg,100,100,face,31,45,82,82,,51,37
810.jpg,100,100,face,31,45,76,80,,45,35
811.jpg,100,100,face,31,44,75,76,,44,32
812.jpg,100,100,face,28,43,72,82,,44,39
813.jpg,100,100,face,33,43,72,75,,39,32
814.jpg,100,100,face,27,43,74,80,,47,37
815.jpg,100,100,face,32,45,70,81,,38,36
816.jpg,100,100,face,35,44,75,79,,40,35
817.jpg,100,100,face,27,43,74,78,,47,35
818.jpg,100,100,face,30,43,73,78,,43,35
819.jpg,100,100,face,31,45,74,82,,43,37
82.jpg,100,100,face,30,44,71,83,,41,39
820.jpg,100,100,face,32,41,76,82,,44,41
821.jpg,100,100,face,31,43,76,79,,45,36
822.jpg,100,100,face,25,42,72,79,,47,37
823.jpg,100,100,face,31,42,76,82,,45,40
824.jpg,100,100,face,32,42,79,84,,47,42
825.jpg,100,100,face,29,43,72,83,,43,40
826.jpg,100,100,face,33,41,73,80,,40,39
827.jpg,100,100,face,32,43,69,78,,37,35
828.jpg,100,100,face,27,43,73,82,,46,39
829.jpg,100,100,face,32,42,68,77,,36,35
83.jpg,100,100,face,32,43,80,78,,48,35
830.jpg,100,100,face,29,42,72,78,,43,36
831.jpg,100,100,face,34,45,73,77,,39,32
832.jpg,100,100,face,29,44,76,79,,47,35
833.jpg,100,100,face,28,44,74,80,,46,36
834.jpg,100,100,face,30,43,77,80,,47,37
835.jpg,100,100,face,26,43,76,80,,50,37
836.jpg,100,100,face,28,42,75,80,,47,38
837.jpg,100,100,face,30,41,70,75,,40,34
838.jpg,100,100,face,28,42,73,80,,45,38
839.jpg,100,100,face,32,43,72,80,,40,37
84.jpg,100,100,face,28,40,70,77,,42,37
840.jpg,100,100,face,28,42,74,79,,46,37
841.jpg,100,100,face,28,41,74,85,,46,44
842.jpg,100,100,face,26,43,77,82,,51,39
843.jpg,100,100,face,32,43,73,79,,41,36
844.jpg,100,100,face,27,43,73,77,,46,34
845.jpg,100,100,face,31,40,66,79,,35,39
846.jpg,100,100,face,31,41,74,78,,43,37
847.jpg,100,100,face,31,43,74,79,,43,36
848.jpg,100,100,face,32,44,73,76,,41,32
849.jpg,100,100,face,34,41,74,87,,40,46
85.jpg,100,100,face,28,42,72,81,,44,39
850.jpg,100,100,face,34,43,72,85,,38,42
851.jpg,100,100,face,32,42,72,85,,40,43
852.jpg,100,100,face,28,41,75,82,,47,41
853.jpg,100,100,face,32,41,75,80,,43,39
854.jpg,100,100,face,30,38,74,81,,44,43
855.jpg,100,100,face,29,41,76,81,,47,40
856.jpg,100,100,face,24,40,71,84,,47,44
857.jpg,100,100,face,27,40,73,79,,46,39
858.jpg,100,100,face,29,43,70,84,,41,41
859.jpg,100,100,face,31,42,72,79,,41,37
86.jpg,100,100,face,29,41,65,78,,36,37
860.jpg,100,100,face,32,43,77,82,,45,39
861.jpg,100,100,face,29,41,74,83,,45,42
862.jpg,100,100,face,32,42,79,80,,47,38
863.jpg,100,100,face,31,39,65,85,,34,46
864.jpg,100,100,face,27,39,72,87,,45,48
865.jpg,100,100,face,27,41,78,79,,51,38
866.jpg,100,100,face,34,37,77,81,,43,44
867.jpg,100,100,face,20,38,77,79,,57,41
868.jpg,100,100,face,29,41,70,80,,41,39
869.jpg,100,100,face,30,41,71,81,,41,40
87.jpg,100,100,face,27,42,75,79,,48,37
870.jpg,100,100,face,26,44,72,83,,46,39
871.jpg,100,100,face,30,43,72,81,,42,38
872.jpg,100,100,face,25,40,68,80,,43,40
873.jpg,100,100,face,27,45,73,79,,46,34
874.jpg,100,100,face,30,42,73,81,,43,39
875.jpg,100,100,face,30,42,72,79,,42,37
876.jpg,100,100,face,29,41,64,84,,35,43
877.jpg,100,100,face,29,44,74,82,,45,38
878.jpg,100,100,face,36,39,79,80,,43,41
879.jpg,100,100,face,27,42,73,81,,46,39
88.jpg,100,100,face,31,42,64,81,,33,39
880.jpg,100,100,face,30,40,68,80,,38,40
881.jpg,100,100,face,25,43,71,83,,46,40
882.jpg,100,100,face,29,42,75,76,,46,34
883.jpg,100,100,face,27,40,72,79,,45,39
884.jpg,100,100,face,28,43,74,79,,46,36
885.jpg,100,100,face,28,44,75,82,,47,38
886.jpg,100,100,face,31,45,73,81,,42,36
887.jpg,100,100,face,33,43,77,81,,44,38
888.jpg,100,100,face,35,42,76,79,,41,37
889.jpg,100,100,face,32,38,81,85,,49,47
89.jpg,100,100,face,29,42,72,82,,43,40
890.jpg,100,100,face,35,43,72,80,,37,37
891.jpg,100,100,face,33,44,72,82,,39,38
892.jpg,100,100,face,31,42,72,78,,41,36
893.jpg,100,100,face,28,42,71,79,,43,37
894.jpg,100,100,face,32,40,72,82,,40,42
895.jpg,100,100,face,30,43,71,80,,41,37
896.jpg,100,100,face,32,41,77,83,,45,42
897.jpg,100,100,face,29,40,75,85,,46,45
898.jpg,100,100,face,31,43,74,84,,43,41
899.jpg,100,100,face,28,43,77,84,,49,41
9.jpg,100,100,face,32,41,70,80,,38,39
90.jpg,100,100,face,30,43,70,79,,40,36
900.jpg,100,100,face,33,43,66,78,,33,35
901.jpg,100,100,face,34,42,75,80,,41,38
902.jpg,100,100,face,31,43,76,84,,45,41
903.jpg,100,100,face,28,42,75,78,,47,36
904.jpg,100,100,face,29,43,67,80,,38,37
905.jpg,100,100,face,30,46,70,80,,40,34
906.jpg,100,100,face,34,46,78,80,,44,34
907.jpg,100,100,face,34,45,71,82,,37,37
908.jpg,100,100,face,30,44,74,81,,44,37
909.jpg,100,100,face,31,41,71,82,,40,41
91.jpg,100,100,face,30,45,71,79,,41,34
910.jpg,100,100,face,33,43,70,78,,37,35
911.jpg,100,100,face,34,43,70,82,,36,39
912.jpg,100,100,face,32,45,71,84,,39,39
913.jpg,100,100,face,27,43,73,85,,46,42
914.jpg,100,100,face,27,44,79,84,,52,40
915.jpg,100,100,face,31,45,70,81,,39,36
916.jpg,100,100,face,28,41,76,81,,48,40
917.jpg,100,100,face,26,45,75,83,,49,38
918.jpg,100,100,face,27,43,75,81,,48,38
919.jpg,100,100,face,30,41,74,80,,44,39
92.jpg,100,100,face,31,43,71,78,,40,35
920.jpg,100,100,face,30,43,74,76,,44,33
921.jpg,100,100,face,31,41,71,80,,40,39
922.jpg,100,100,face,30,44,73,84,,43,40
923.jpg,100,100,face,25,41,68,82,,43,41
924.jpg,100,100,face,28,42,71,75,,43,33
925.jpg,100,100,face,32,44,70,78,,38,34
926.jpg,100,100,face,29,42,76,81,,47,39
927.jpg,100,100,face,30,42,76,79,,46,37
928.jpg,100,100,face,30,41,72,79,,42,38
929.jpg,100,100,face,28,42,76,81,,48,39
93.jpg,100,100,face,30,41,75,79,,45,38
930.jpg,100,100,face,26,39,74,77,,48,38
931.jpg,100,100,face,30,44,70,83,,40,39
932.jpg,100,100,face,31,44,72,80,,41,36
933.jpg,100,100,face,29,42,71,80,,42,38
934.jpg,100,100,face,32,42,74,79,,42,37
935.jpg,100,100,face,28,41,72,79,,44,38
936.jpg,100,100,face,28,42,73,81,,45,39
937.jpg,100,100,face,27,42,71,78,,44,36
938.jpg,100,100,face,27,44,71,77,,44,33
939.jpg,100,100,face,25,44,74,78,,49,34
94.jpg,100,100,face,30,44,73,80,,43,36
940.jpg,100,100,face,30,41,69,76,,39,35
941.jpg,100,100,face,26,40,75,78,,49,38
942.jpg,100,100,face,26,39,76,79,,50,40
943.jpg,100,100,face,26,45,68,79,,42,34
944.jpg,100,100,face,25,41,75,81,,50,40
945.jpg,100,100,face,26,41,72,80,,46,39
946.jpg,100,100,face,27,42,76,80,,49,38
947.jpg,100,100,face,30,39,78,78,,48,39
948.jpg,100,100,face,27,40,80,77,,53,37
949.jpg,100,100,face,28,42,71,80,,43,38
95.jpg,100,100,face,28,45,69,78,,41,33
950.jpg,100,100,face,26,41,75,78,,49,37
951.jpg,100,100,face,26,40,78,84,,52,44
952.jpg,100,100,face,25,42,76,79,,51,37
953.jpg,100,100,face,28,40,70,77,,42,37
954.jpg,100,100,face,29,43,73,83,,44,40
955.jpg,100,100,face,28,40,74,79,,46,39
956.jpg,100,100,face,31,41,71,80,,40,39
957.jpg,100,100,face,27,43,72,79,,45,36
958.jpg,100,100,face,28,43,74,81,,46,38
959.jpg,100,100,face,29,41,72,76,,43,35
96.jpg,100,100,face,31,43,73,81,,42,38
960.jpg,100,100,face,32,42,66,81,,34,39
961.jpg,100,100,face,29,40,67,83,,38,43
962.jpg,100,100,face,30,40,66,80,,36,40
963.jpg,100,100,face,32,42,69,82,,37,40
964.jpg,100,100,face,29,44,75,82,,46,38
965.jpg,100,100,face,30,44,72,81,,42,37
966.jpg,100,100,face,30,43,72,80,,42,37
967.jpg,100,100,face,31,44,70,82,,39,38
968.jpg,100,100,face,29,46,74,84,,45,38
969.jpg,100,100,face,30,41,72,82,,42,41
97.jpg,100,100,face,29,41,73,83,,44,42
970.jpg,100,100,face,29,42,76,83,,47,41
971.jpg,100,100,face,30,40,78,80,,48,40
972.jpg,100,100,face,30,44,71,80,,41,36
973.jpg,100,100,face,33,39,73,83,,40,44
974.jpg,100,100,face,32,45,73,83,,41,38
975.jpg,100,100,face,34,42,68,80,,34,38
976.jpg,100,100,face,28,44,73,81,,45,37
977.jpg,100,100,face,32,42,63,81,,31,39
978.jpg,100,100,face,30,40,73,82,,43,42
979.jpg,100,100,face,30,43,72,82,,42,39
98.jpg,100,100,face,31,40,75,80,,44,40
980.jpg,100,100,face,33,43,68,78,,35,35
981.jpg,100,100,face,34,43,69,79,,35,36
982.jpg,100,100,face,31,43,71,80,,40,37
983.jpg,100,100,face,28,41,74,79,,46,38
984.jpg,100,100,face,31,42,69,83,,38,41
985.jpg,100,100,face,29,41,69,80,,40,39
986.jpg,100,100,face,29,44,80,85,,51,41
987.jpg,100,100,face,29,43,71,82,,42,39
988.jpg,100,100,face,30,44,77,84,,47,40
989.jpg,100,100,face,28,41,70,84,,42,43
99.jpg,100,100,face,32,45,66,87,,34,42
990.jpg,100,100,face,29,42,75,79,,46,37
991.jpg,100,100,face,27,45,77,83,,50,38
992.jpg,100,100,face,30,44,73,82,,43,38
993.jpg,100,100,face,26,44,74,82,,48,38
994.jpg,100,100,face,29,44,75,85,,46,41
995.jpg,100,100,face,31,44,75,79,,44,35
996.jpg,100,100,face,29,45,76,80,,47,35
997.jpg,100,100,face,26,43,76,80,,50,37
998.jpg,100,100,face,26,40,75,81,,49,41
999.jpg,100,100,face,35,40,75,86,,40,46
,,,,,,,,,27,26
,,,,,,,,,69,50
